Fecha de Operación,Fecha,Referencia,Descripcion,Cod. Transac,Sucursal,Depósitos,Retiros,Saldo,Movimiento,Descripción Detallada
31/01/2015,03/02/2015,0,DEP.EFECTIVO 108204051,0,188,1630.50,,137126.91,5602,
31/01/2015,03/02/2015,0,DEP.EFECTIVO 111024058,0,1490,935.00,,138061.91,5603,
31/01/2015,03/02/2015,0,DEP.EFECTIVO 117513054,0,1566,5184.50,,143246.41,5604,
31/01/2015,03/02/2015,0,DEP.EFECTIVO 116501057,0,1424,3446.50,,146692.91,5605,
03/02/2015,03/02/2015,0,DEP.EFECTIVO 133448053,0,2460,3166.00,,149858.91,5606,
03/02/2015,03/02/2015,0,DEP.EFECTIVO 133448061,0,2460,1942.50,,151801.41,5607,
03/02/2015,03/02/2015,0,DEP.EFECTIVO 133448079,0,2460,1417.50,,153218.91,5608,
03/02/2015,03/02/2015,0,DEP.EFECTIVO 133448012,0,2460,764.50,,153983.41,5609,
03/02/2015,03/02/2015,0,DEP.EFECTIVO 124901052,0,2104,1904.00,,155887.41,5610,
03/02/2015,03/02/2015,0,DEP.EFECTIVO 124901060,0,2104,2502.00,,158389.41,5611,
03/02/2015,03/02/2015,0,DEP.EFECTIVO 124901078,0,2104,2469.50,,160858.91,5612,
03/02/2015,03/02/2015,0,DEP.EFECTIVO 124901011,0,2104,1233.50,,162092.41,5613,
03/02/2015,03/02/2015,0,DEP.EFECTIVO 117001050,0,274,1929.50,,164021.91,5614,
03/02/2015,03/02/2015,0,DEP.EFECTIVO 117001076,0,274,375.50,,164397.41,5615,
03/02/2015,03/02/2015,0,DEP.EFECTIVO 117001068,0,274,2664.50,,167061.91,5616,
03/02/2015,03/02/2015,0,DEP.EFECTIVO 117001019,0,274,526.00,,167587.91,5617,
03/02/2015,03/02/2015,0,DEP.EFECTIVO 117901051,0,2067,1755.50,,169343.41,5618,
03/02/2015,03/02/2015,0,DEP.EFECTIVO 117901069,0,2067,1844.50,,171187.91,5619,
03/02/2015,03/02/2015,0,DEP.EFECTIVO 117901010,0,2067,1474.00,,172661.91,5620,
03/02/2015,03/02/2015,0,DEP.EFECTIVO 111501071,0,2290,3123.00,,175784.91,5621,
03/02/2015,03/02/2015,0,DEP.EFECTIVO 111501063,0,2290,2703.00,,178487.91,5622,
03/02/2015,03/02/2015,0,DEP.EFECTIVO 117901077,0,2067,2034.50,,180522.41,5623,
03/02/2015,03/02/2015,0,DEP.EFECTIVO 111501055,0,2290,3189.00,,183711.41,5624,
03/02/2015,03/02/2015,0,DEP.EFECTIVO 111501014,0,2290,2543.50,,186254.91,5625,
03/02/2015,03/02/2015,0,DEP.EFECTIVO 131801055,0,2102,3917.50,,190172.41,5626,
03/02/2015,03/02/2015,0,DEP.EFECTIVO 92508053,0,3630,4812.75,,194985.16,5627,
03/02/2015,03/02/2015,0,DEP.EFECTIVO 131801071,0,2102,1928.50,,196913.66,5628,
03/02/2015,03/02/2015,0,DEP.EFECTIVO 92508079,0,3630,3225.50,,200139.16,5629,
03/02/2015,03/02/2015,0,DEP.EFECTIVO 13801063,0,2102,2667.50,,202806.66,5630,
03/02/2015,03/02/2015,0,DEP.EFECTIVO 92508012,0,3630,2827.50,,205634.16,5631,
03/02/2015,03/02/2015,0,DEP.EFECTIVO 106414058,0,8014,1821.50,,207455.66,5632,
03/02/2015,03/02/2015,0,DEP.EFECTIVO 131801014,0,2102,1267.50,,208723.16,5633,
03/02/2015,03/02/2015,0,DEP.EFECTIVO 92508061,0,3630,5309.50,,214032.66,5634,
03/02/2015,03/02/2015,0,DEP.EFECTIVO 106414066,0,8014,2679.91,,216712.57,5635,
03/02/2015,03/02/2015,0,DEP.EFECTIVO 118701016,0,2314,1799.50,,218512.07,5636,
03/02/2015,03/02/2015,0,DEP.EFECTIVO 118701057,0,2314,1410.00,,219922.07,5637,
03/02/2015,03/02/2015,0,DEP.EFECTIVO 106414074,0,8014,2339.50,,222261.57,5638,
03/02/2015,03/02/2015,0,DEP.EFECTIVO 141301057,0,2102,824.50,,223086.07,5639,
03/02/2015,03/02/2015,0,DEP.EFECTIVO 118701065,0,2314,2959.00,,226045.07,5640,
03/02/2015,03/02/2015,0,DEP.EFECTIVO,0,1424,5137.96,,231183.03,5641,
03/02/2015,03/02/2015,0,DEP.EFECTIVO 141301016,0,2102,197.50,,231380.53,5642,
03/02/2015,03/02/2015,0,DEP.EFECTIVO 106414017,0,8014,1611.00,,232991.53,5643,
03/02/2015,03/02/2015,0,DEP.EFECTIVO 118701073,0,2314,836.50,,233828.03,5644,
03/02/2015,03/02/2015,0,DEP.EFECTIVO 141301073,0,2102,286.00,,234114.03,5645,
03/02/2015,03/02/2015,200,TRASPASO A CUENTA PROPIA,790,8846,,"$214,032.66",20081.37,5646,"IVA:00000000.00 , A LA CUENTA 0136679699, 200 AL R.F.C. FTI9211036K2"
03/02/2015,03/02/2015,0,ANUL.DEP.EFECTIVO,501,1424,,"$5,137.96",14943.41,5647,
03/02/2015,03/02/2015,0,DEP.EFECTIVO 141301065,0,2102,330.80,,15274.21,5648,
03/02/2015,03/02/2015,0,DEP.EFECTIVO 098301073,0,2314,5370.00,,20644.21,5649,
03/02/2015,03/02/2015,0,DEP.EFECTIVO 116501065,0,1424,5137.96,,25782.17,5650,
03/02/2015,03/02/2015,0,DEP.EFECTIVO 098301016,0,2314,1383.00,,27165.17,5651,
03/02/2015,03/02/2015,0,DEP.EFECTIVO 116501016,0,1424,1294.50,,28459.67,5652,
03/02/2015,03/02/2015,0,DEP.EFECTIVO 116501073,0,1424,1608.50,,30068.17,5653,
03/02/2015,03/02/2015,0,DEP.EFECTIVO 098301065,0,2314,3771.00,,33839.17,5654,
03/02/2015,03/02/2015,0,DEP.EFECTIVO 098301057,0,2314,3216.50,,37055.67,5655,
03/02/2015,03/02/2015,0,DEP.EFECTIVO 1209130619,0,1536,1527.00,,38582.67,5656,
03/02/2015,03/02/2015,0,DEP.EFECTIVO 1209130556,0,1536,989.50,,39572.17,5657,
03/02/2015,03/02/2015,0,DEP.EFECTIVO 1209130493,0,1536,813.00,,40385.17,5658,
03/02/2015,03/02/2015,0,DEP.EFECTIVO 1209130333,0,1536,966.00,,41351.17,5659,
03/02/2015,03/02/2015,0,DEP.EFECTIVO 110501065,0,8014,1772.50,,43123.67,5660,
03/02/2015,03/02/2015,0,DEP.EFECTIVO 110501057,0,8014,2045.00,,45168.67,5661,
03/02/2015,03/02/2015,0,DEP.EFECTIVO 110501016,0,8014,1925.00,,47093.67,5662,
03/02/2015,03/02/2015,0,DEP.EFECTIVO 041201065,0,2325,3579.00,,50672.67,5663,
03/02/2015,03/02/2015,0,DEP.EFECTIVO 041201057,0,2325,2949.50,,53622.17,5664,
03/02/2015,03/02/2015,0,DEP.EFECTIVO 041201016,0,2325,2614.50,,56236.67,5665,
03/02/2015,03/02/2015,0,DEP.EFECTIVO 041201073,0,2325,847.50,,57084.17,5666,
03/02/2015,03/02/2015,0,DEP.EFECTIVO 102914051,0,8015,961.50,,58045.67,5667,
03/02/2015,03/02/2015,0,DEP.EFECTIVO 102914069,0,8015,987.36,,59033.03,5668,
03/02/2015,03/02/2015,0,DEP.EFECTIVO 102914010,0,8015,856.50,,59889.53,5669,
03/02/2015,03/02/2015,0,DEP.EFECTIVO 102914077,0,8015,1578.50,,61468.03,5670,
03/02/2015,03/02/2015,0,DEP.EFECTIVO 124301014,0,1474,1387.50,,62855.53,5671,
03/02/2015,03/02/2015,0,DEP.EFECTIVO 124301055,0,1474,2387.50,,65243.03,5672,
03/02/2015,03/02/2015,0,DEP.EFECTIVO 124301063,0,1474,2800.00,,68043.03,5673,
03/02/2015,03/02/2015,0,DEP.EFECTIVO 124301071,0,1474,1252.40,,69295.43,5674,
03/02/2015,03/02/2015,0,DEP.EFECTIVO 133301070,0,2162,1398.50,,70693.93,5675,
03/02/2015,03/02/2015,0,DEP.EFECTIVO 133301062,0,2162,922.00,,71615.93,5676,
03/02/2015,03/02/2015,0,DEP.EFECTIVO 133301013,0,2162,1202.00,,72817.93,5677,
03/02/2015,03/02/2015,0,DEP.EFECTIVO 133301054,0,2162,2709.50,,75527.43,5678,
03/02/2015,03/02/2015,0,ANUL.DEP.EFECTIVO 09830,501,2314,,"$3,771.00",71756.43,5679,
03/02/2015,03/02/2015,0,DEP.EFECTIVO 098301065,0,2314,3124.50,,74880.93,5680,
03/02/2015,03/02/2015,0,DEP.EFECTIVO 098301016,0,2314,2.00,,74882.93,5681,
03/02/2015,03/02/2015,0,DEP.EFECTIVO 117513062,0,1508,4868.00,,79750.93,5682,
03/02/2015,03/02/2015,0,DEP.EFECTIVO 117513070,0,1508,3440.00,,83190.93,5683,
03/02/2015,03/02/2015,0,DEP.EFECTIVO 117513013,0,1508,1356.50,,84547.43,5684,
03/02/2015,03/02/2015,0,DEP.EFECTIVO 102210054,0,8114,1451.50,,85998.93,5685,
03/02/2015,03/02/2015,0,DEP.EFECTIVO 102210013,0,8114,1238.50,,87237.43,5686,
03/02/2015,03/02/2015,0,DEP.EFECTIVO 102210070,0,8114,760.00,,87997.43,5687,
03/02/2015,03/02/2015,0,DEP.EFECTIVO 102210062,0,8114,1421.00,,89418.43,5688,
03/02/2015,03/02/2015,0,DEP.EFECTIVO 1090100590,0,8114,3811.00,,93229.43,5689,
03/02/2015,03/02/2015,0,DEP.EFECTIVO 1090100653,0,8114,2633.70,,95863.13,5690,
03/02/2015,03/02/2015,0,DEP.EFECTIVO 1090100716,0,8114,1881.20,,97744.33,5691,
03/02/2015,03/02/2015,0,DEP.EFECTIVO 1090100144,0,8114,1239.20,,98983.53,5692,
03/02/2015,03/02/2015,0,DEP.EFECTIVO 34602078,0,52,2016.50,,101000.03,5693,
03/02/2015,03/02/2015,0,DEP.EFECTIVO 34602011,0,52,952.00,,101952.03,5694,
03/02/2015,03/02/2015,0,DEP.EFECTIVO 34602060,0,52,1333.10,,103285.13,5695,
03/02/2015,03/02/2015,0,DEP.EFECTIVO 34602052,0,52,2583.50,,105868.63,5696,
03/02/2015,03/02/2015,0,DEP.EFECTIVO 1291020161,0,3682,558.45,,106427.08,5697,
03/02/2015,03/02/2015,0,DEP.EFECTIVO 1291020384,0,3682,859.55,,107286.63,5698,
03/02/2015,03/02/2015,0,DEP.EFECTIVO 1291020161,0,3682,391.20,,107677.83,5699,
03/02/2015,03/02/2015,0,DEP.EFECTIVO 1291020224,0,3682,2112.10,,109789.93,5700,
03/02/2015,03/02/2015,0,DEP.EFECTIVO 1291020733,0,3682,924.10,,110714.03,5701,
03/02/2015,03/02/2015,0,DEP.EFECTIVO 1291020670,0,3682,569.40,,111283.43,5702,
03/02/2015,03/02/2015,0,DEP.EFECTIVO 1282030799,0,3190,1759.50,,113042.93,5703,
03/02/2015,03/02/2015,0,DEP.EFECTIVO 1291020447,0,3682,904.90,,113947.83,5704,
03/02/2015,03/02/2015,0,DEP.EFECTIVO 121701059,0,831,686.00,,114633.83,5705,
03/02/2015,03/02/2015,0,DEP.EFECTIVO 1282030639,0,3190,1570.50,,116204.33,5706,
03/02/2015,03/02/2015,0,DEP.EFECTIVO 121701075,0,831,1543.76,,117748.09,5707,
03/02/2015,03/02/2015,0,DEP.EFECTIVO 1291020510,0,3682,1017.80,,118765.89,5708,
03/02/2015,03/02/2015,0,DEP.EFECTIVO 121701018,0,831,653.00,,119418.89,5709,
03/02/2015,03/02/2015,0,DEP.EFECTIVO 1282030576,0,3190,2036.00,,121454.89,5710,
03/02/2015,03/02/2015,0,DEP.EFECTIVO 1282030130,0,3190,3187.00,,124641.89,5711,
03/02/2015,03/02/2015,0,DEP.EFECTIVO 119613035,0,7726,941.00,,125582.89,5712,
03/02/2015,03/02/2015,0,DEP.EFECTIVO 119613043,0,7726,608.50,,126191.39,5713,
03/02/2015,03/02/2015,0,DEP.EFECTIVO 119613050,0,7726,942.00,,127133.39,5714,
03/02/2015,03/02/2015,0,DEP.EFECTIVO 119613068,0,7726,1724.30,,128857.69,5715,
03/02/2015,03/02/2015,0,DEP.EFECTIVO 117101017,0,2162,469.50,,129327.19,5716,
03/02/2015,03/02/2015,0,DEP.EFECTIVO 117101058,0,2162,3571.00,,132898.19,5717,
03/02/2015,03/02/2015,0,DEP.EFECTIVO 117101066,0,2162,1356.50,,134254.69,5718,
03/02/2015,03/02/2015,0,DEP.EFECTIVO 117101074,0,2162,1082.00,,135336.69,5719,
03/02/2015,03/02/2015,0,DEP.EFECTIVO 119101016,0,2126,1104.00,,136440.69,5720,
03/02/2015,03/02/2015,0,DEP.EFECTIVO 119101057,0,2126,2107.50,,138548.19,5721,
03/02/2015,03/02/2015,0,DEP.EFECTIVO 119101073,0,2126,868.00,,139416.19,5722,
03/02/2015,03/02/2015,0,DEP.EFECTIVO 119101065,0,2126,1235.50,,140651.69,5723,
03/02/2015,03/02/2015,0,DEP.EFECTIVO 33402066,0,52,1522.19,,142173.88,5724,
03/02/2015,03/02/2015,0,DEP.EFECTIVO 124601074,0,116,703.50,,142877.38,5725,
03/02/2015,03/02/2015,0,DEP.EFECTIVO 33402074,0,52,2629.50,,145506.88,5726,
03/02/2015,03/02/2015,0,DEP.EFECTIVO 098301065,0,463,400.00,,145906.88,5727,
03/02/2015,03/02/2015,0,DEP.EFECTIVO 33402017,0,52,1179.00,,147085.88,5728,
03/02/2015,03/02/2015,0,DEP.EFECTIVO 124601066,0,116,2277.50,,149363.38,5729,
03/02/2015,03/02/2015,0,DEP.EFECTIVO 33402058,0,52,1995.00,,151358.38,5730,
03/02/2015,03/02/2015,0,DEP.EFECTIVO 124601058,0,116,3265.50,,154623.88,5731,
03/02/2015,03/02/2015,0,DEP.EFECTIVO 33402074,0,52,20.00,,154643.88,5732,
03/02/2015,03/02/2015,0,DEP.EFECTIVO 0124601074,0,116,936.50,,155580.38,5733,
03/02/2015,03/02/2015,0,DEP.EFECTIVO 141001050,0,2009,2628.00,,158208.38,5734,
03/02/2015,03/02/2015,0,DEP.EFECTIVO 141001068,0,2009,1828.50,,160036.88,5735,
03/02/2015,03/02/2015,0,DEP.EFECTIVO 141001076,0,2009,1353.50,,161390.38,5736,
03/02/2015,03/02/2015,0,DEP.EFECTIVO 141001019,0,2009,1065.50,,162455.88,5737,
03/02/2015,03/02/2015,0,DEP.EFECTIVO 1114130550,0,1974,1821.50,,164277.38,5738,
03/02/2015,03/02/2015,0,DEP.EFECTIVO 1114130104,0,1974,1684.50,,165961.88,5739,
03/02/2015,03/02/2015,0,DEP.EFECTIVO 1114130613,0,1974,2543.50,,168505.38,5740,
03/02/2015,03/02/2015,0,DEP.EFECTIVO 1114130773,0,1974,2313.80,,170819.18,5741,
03/02/2015,03/02/2015,0,DEP.EFECTIVO 1114130487,0,1974,1695.00,,172514.18,5742,
03/02/2015,03/02/2015,0,DEP.EFECTIVO 137001056,0,451,922.10,,173436.28,5743,
03/02/2015,03/02/2015,0,DEP.EFECTIVO 137001064,0,451,917.70,,174353.98,5744,
03/02/2015,03/02/2015,0,DEP.EFECTIVO 98001061,0,1477,1909.50,,176263.48,5745,
03/02/2015,03/02/2015,0,DEP.EFECTIVO 98001079,0,1477,719.50,,176982.98,5746,
03/02/2015,03/02/2015,0,DEP.EFECTIVO 98001046,0,1477,1440.50,,178423.48,5747,
03/02/2015,03/02/2015,0,DEP.EFECTIVO 98001053,0,1477,1987.00,,180410.48,5748,
03/02/2015,03/02/2015,0,DEP.EFECTIVO 98001038,0,1477,1766.50,,182176.98,5749,
03/02/2015,03/02/2015,0,DEP.EFECTIVO 98001020,0,1477,2008.00,,184184.98,5750,
03/02/2015,03/02/2015,0,DEP.EFECTIVO 119301065,0,1508,844.50,,185029.48,5751,
03/02/2015,03/02/2015,0,DEP.EFECTIVO 119301057,0,1508,1441.50,,186470.98,5752,
03/02/2015,03/02/2015,0,DEP.EFECTIVO 123601018,0,2306,397.50,,186868.48,5753,
03/02/2015,03/02/2015,0,DEP.EFECTIVO 123601059,0,2306,1253.50,,188121.98,5754,
03/02/2015,03/02/2015,0,DEP.EFECTIVO 115901053,0,8013,1591.00,,189712.98,5755,
03/02/2015,03/02/2015,0,DEP.EFECTIVO 123601067,0,2306,1770.50,,191483.48,5756,
03/02/2015,03/02/2015,0,DEP.EFECTIVO 115901061,0,8013,1537.50,,193020.98,5757,
03/02/2015,03/02/2015,0,DEP.EFECTIVO 123601075,0,2306,1258.00,,194278.98,5758,
03/02/2015,03/02/2015,0,DEP.EFECTIVO 115901012,0,8013,3196.50,,197475.48,5759,
03/02/2015,03/02/2015,0,DEP.EFECTIVO 1332201031,0,2183,0.10,,197475.58,5760,
03/02/2015,03/02/2015,0,DEP.EFECTIVO 100101065,0,2326,1163.70,,198639.28,5761,
03/02/2015,03/02/2015,0,DEP.EFECTIVO 133201049,0,2183,67.50,,198706.78,5762,
03/02/2015,03/02/2015,0,DEP.EFECTIVO 100101057,0,2326,2045.50,,200752.28,5763,
03/02/2015,03/02/2015,0,DEP.EFECTIVO 133201072,0,2183,734.00,,201486.28,5764,
03/02/2015,03/02/2015,0,DEP.EFECTIVO 100101016,0,2326,1576.00,,203062.28,5765,
03/02/2015,03/02/2015,0,DEP.EFECTIVO 133201064,0,2183,532.00,,203594.28,5766,
03/02/2015,03/02/2015,0,DEP.EFECTIVO 100101073,0,2326,2795.50,,206389.78,5767,
03/02/2015,03/02/2015,0,DEP.EFECTIVO 133201056,0,2183,2213.00,,208602.78,5768,
03/02/2015,03/02/2015,0,DEP.EFECTIVO 133201015,0,2183,541.00,,209143.78,5769,
03/02/2015,03/02/2015,0,DEP.EFECTIVO 1000300663,0,2552,2273.59,,211417.37,5770,
03/02/2015,03/02/2015,0,DEP.EFECTIVO 126301049,0,464,2334.00,,213751.37,5771,
03/02/2015,03/02/2015,0,DEP.EFECTIVO 126301057,0,464,3258.50,,217009.87,5772,
03/02/2015,03/02/2015,0,DEP.EFECTIVO 150401016,0,2043,1030.00,,218039.87,5773,
03/02/2015,03/02/2015,0,DEP.EFECTIVO 126301016,0,464,1081.00,,219120.87,5774,
03/02/2015,03/02/2015,0,DEP.EFECTIVO 1000300154,0,2552,1544.50,,220665.37,5775,
03/02/2015,03/02/2015,0,DEP.EFECTIVO 150401065,0,2043,2703.00,,223368.37,5776,
03/02/2015,03/02/2015,0,DEP.EFECTIVO 1000300726,0,2552,1554.50,,224922.87,5777,
03/02/2015,03/02/2015,0,DEP.EFECTIVO 126301073,0,464,2379.00,,227301.87,5778,
03/02/2015,03/02/2015,0,DEP.EFECTIVO 150401073,0,2043,1026.50,,228328.37,5779,
03/02/2015,03/02/2015,0,DEP.EFECTIVO 1000300503,0,2552,2201.50,,230529.87,5780,
03/02/2015,03/02/2015,0,DEP.EFECTIVO 126301065,0,464,2829.00,,233358.87,5781,
03/02/2015,03/02/2015,0,DEP.EFECTIVO 094301073,0,1938,1338.00,,234696.87,5782,
03/02/2015,03/02/2015,0,DEP.EFECTIVO 150401057,0,2043,3741.50,,238438.37,5783,
03/02/2015,03/02/2015,0,DEP.EFECTIVO 094301057,0,1938,1980.00,,240418.37,5784,
03/02/2015,03/02/2015,0,DEP.EFECTIVO 094301065,0,1938,2096.50,,242514.87,5785,
03/02/2015,03/02/2015,0,DEP.EFECTIVO 094301016,0,1938,1046.50,,243561.37,5786,
03/02/2015,03/02/2015,0,DEP.EFECTIVO 107701057,0,2162,1879.50,,245440.87,5787,
03/02/2015,03/02/2015,0,DEP.EFECTIVO 107701065,0,2162,1413.70,,246854.57,5788,
03/02/2015,03/02/2015,0,DEP.EFECTIVO 104727011,0,3705,1404.50,,248259.07,5789,
03/02/2015,03/02/2015,0,DEP.EFECTIVO 107701073,0,2162,1417.50,,249676.57,5790,
03/02/2015,03/02/2015,0,DEP.EFECTIVO 107701016,0,2162,1576.50,,251253.07,5791,
03/02/2015,03/02/2015,0,DEP.EFECTIVO 104727060,0,3705,1945.50,,253198.57,5792,
03/02/2015,03/02/2015,0,DEP.EFECTIVO 104727078,0,3705,811.00,,254009.57,5793,
03/02/2015,03/02/2015,0,DEP.EFECTIVO 96901015,0,2043,1131.00,,255140.57,5794,
03/02/2015,03/02/2015,0,DEP.EFECTIVO 104727052,0,3705,1178.00,,256318.57,5795,
03/02/2015,03/02/2015,0,DEP.EFECTIVO 96901072,0,2043,3032.00,,259350.57,5796,
03/02/2015,03/02/2015,0,DEP.EFECTIVO 1145300521,0,2552,1251.00,,260601.57,5797,
03/02/2015,03/02/2015,0,DEP.EFECTIVO 131013065,0,1508,1506.00,,262107.57,5798,
03/02/2015,03/02/2015,0,DEP.EFECTIVO 96901064,0,2043,3133.50,,265241.07,5799,
03/02/2015,03/02/2015,0,DEP.EFECTIVO,0,2552,2069.00,,267310.07,5800,
03/02/2015,03/02/2015,0,DEP.EFECTIVO 96901056,0,2043,2231.50,,269541.57,5801,
03/02/2015,03/02/2015,0,DEP.EFECTIVO 131013057,0,1508,1878.00,,271419.57,5802,
03/02/2015,03/02/2015,0,DEP.EFECTIVO 35102011,0,52,1496.00,,272915.57,5803,
03/02/2015,03/02/2015,0,DEP.EFECTIVO 35102078,0,52,1895.00,,274810.57,5804,
03/02/2015,03/02/2015,0,DEP.EFECTIVO 131013040,0,1508,1718.50,,276529.07,5805,
03/02/2015,03/02/2015,0,DEP.EFECTIVO 1145300681,0,2552,2462.46,,278991.53,5806,
03/02/2015,03/02/2015,0,DEP.EFECTIVO 111024066,0,2605,2741.50,,281733.03,5807,
03/02/2015,03/02/2015,0,DEP.EFECTIVO 111024017,0,2605,981.00,,282714.03,5808,
03/02/2015,03/02/2015,0,DEP.EFECTIVO 1145300172,0,2552,885.50,,283599.53,5809,
03/02/2015,03/02/2015,0,DEP.EFECTIVO 35102052,0,52,2162.00,,285761.53,5810,
03/02/2015,03/02/2015,0,DEP.EFECTIVO 111024074,0,2605,1282.50,,287044.03,5811,
03/02/2015,03/02/2015,0,DEP.EFECTIVO 35102060,0,52,2320.93,,289364.96,5812,
03/02/2015,03/02/2015,0,DEP.EFECTIVO 91402068,0,727,1364.40,,290729.36,5813,
03/02/2015,03/02/2015,0,DEP.EFECTIVO 91402019,0,727,795.50,,291524.86,5814,
03/02/2015,03/02/2015,0,DEP.EFECTIVO 093001065,0,691,4148.00,,295672.86,5815,
03/02/2015,03/02/2015,0,ANUL.DEP.EFECTIVO,501,2552,,"$2,069.00",293603.86,5816,
03/02/2015,03/02/2015,0,DEP.EFECTIVO 093001057,0,691,1699.50,,295303.36,5817,
03/02/2015,03/02/2015,0,DEP.EFECTIVO 1145300744,0,2552,2069.00,,297372.36,5818,
03/02/2015,03/02/2015,0,DEP.EFECTIVO 91402050,0,727,1741.20,,299113.56,5819,
03/02/2015,03/02/2015,0,DEP.EFECTIVO 093001073,0,691,1834.00,,300947.56,5820,
03/02/2015,03/02/2015,0,DEP.EFECTIVO 91402076,0,727,2533.00,,303480.56,5821,
03/02/2015,03/02/2015,0,DEP.EFECTIVO 093001016,0,691,1413.50,,304894.06,5822,
03/02/2015,03/02/2015,0,DEP.EFECTIVO 120501016,0,2382,1616.00,,306510.06,5823,
03/02/2015,03/02/2015,0,DEP.EFECTIVO 121201050,0,275,1207.00,,307717.06,5824,
03/02/2015,03/02/2015,0,DEP.EFECTIVO 121201068,0,275,1126.40,,308843.46,5825,
03/02/2015,03/02/2015,0,DEP.EFECTIVO 120501057,0,2382,2104.00,,310947.46,5826,
03/02/2015,03/02/2015,0,DEP.EFECTIVO 099301073,0,2382,669.00,,311616.46,5827,
03/02/2015,03/02/2015,0,DEP.EFECTIVO 121201076,0,275,663.00,,312279.46,5828,
03/02/2015,03/02/2015,0,DEP.EFECTIVO 099301065,0,2382,1596.50,,313875.96,5829,
03/02/2015,03/02/2015,0,DEP.EFECTIVO 120501065,0,2382,2276.00,,316151.96,5830,
03/02/2015,03/02/2015,0,DEP.EFECTIVO 121201019,0,275,571.00,,316722.96,5831,
03/02/2015,03/02/2015,0,DEP.EFECTIVO 120501073,0,2382,1811.00,,318533.96,5832,
03/02/2015,03/02/2015,0,DEP.EFECTIVO 122701065,0,2382,1184.50,,319718.46,5833,
03/02/2015,03/02/2015,0,DEP.EFECTIVO 13160106,0,117,2946.50,,322664.96,5834,
03/02/2015,03/02/2015,0,DEP.EFECTIVO 13160101,0,117,1020.50,,323685.46,5835,
03/02/2015,03/02/2015,0,DEP.EFECTIVO 95401016,0,295,939.00,,324624.46,5836,
03/02/2015,03/02/2015,0,DEP.EFECTIVO 13160107,0,117,2766.00,,327390.46,5837,
03/02/2015,03/02/2015,0,DEP.EFECTIVO 095401065,0,295,1516.50,,328906.96,5838,
03/02/2015,03/02/2015,0,DEP.EFECTIVO 95401057,0,295,2482.00,,331388.96,5839,
03/02/2015,03/02/2015,0,DEP.EFECTIVO 13160105,0,117,2177.50,,333566.46,5840,
03/02/2015,03/02/2015,0,DEP.EFECTIVO 095401073,0,295,908.50,,334474.96,5841,
03/02/2015,03/02/2015,0,DEP.EFECTIVO 099301057,0,2382,934.50,,335409.46,5842,
03/02/2015,03/02/2015,0,DEP.EFECTIVO 122701073,0,2382,598.00,,336007.46,5843,
03/02/2015,03/02/2015,0,DEP.EFECTIVO 099301016,0,2382,1256.50,,337263.96,5844,
03/02/2015,03/02/2015,0,DEP.EFECTIVO 122701016,0,2382,553.50,,337817.46,5845,
03/02/2015,03/02/2015,0,DEP.EFECTIVO 96824050,0,1490,2646.50,,340463.96,5846,
03/02/2015,03/02/2015,0,DEP.EFECTIVO,0,188,2326.50,,342790.46,5847,
03/02/2015,03/02/2015,0,DEP.EFECTIVO 129201013,0,295,1521.50,,344311.96,5848,
03/02/2015,03/02/2015,0,DEP.EFECTIVO 122701057,0,2382,1104.50,,345416.46,5849,
03/02/2015,03/02/2015,0,DEP.EFECTIVO,0,1490,2481.60,,347898.06,5850,
03/02/2015,03/02/2015,0,DEP.EFECTIVO 99401051,0,2162,1263.00,,349161.06,5851,
03/02/2015,03/02/2015,0,DEP.EFECTIVO 129201016,0,295,883.50,,350044.56,5852,
03/02/2015,03/02/2015,0,DEP.EFECTIVO 96824076,0,1490,1151.06,,351195.62,5853,
03/02/2015,03/02/2015,0,DEP.EFECTIVO 99401077,0,2162,1916.50,,353112.12,5854,
03/02/2015,03/02/2015,0,DEP.EFECTIVO 129201015,0,295,1523.80,,354635.92,5855,
03/02/2015,03/02/2015,0,DEP.EFECTIVO 96824019,0,1490,1300.00,,355935.92,5856,
03/02/2015,03/02/2015,0,ANUL.DEP.EFECTIVO,501,188,,"$2,326.50",353609.42,5857,
03/02/2015,03/02/2015,0,DEP.EFECTIVO 129201017,0,295,1806.00,,355415.42,5858,
03/02/2015,03/02/2015,0,DEP.EFECTIVO 99401069,0,2162,2275.50,,357690.92,5859,
03/02/2015,03/02/2015,0,DEP.EFECTIVO 99401010,0,2162,827.50,,358518.42,5860,
03/02/2015,03/02/2015,0,DEP.EFECTIVO 141601057,0,2162,905.50,,359423.92,5861,
03/02/2015,03/02/2015,0,DEP.EFECTIVO 141601065,0,2162,916.50,,360340.42,5862,
03/02/2015,03/02/2015,0,DEP.EFECTIVO 108204069,0,188,2326.50,,362666.92,5863,
03/02/2015,03/02/2015,0,DEP.EFECTIVO 141601073,0,2162,469.50,,363136.42,5864,
03/02/2015,03/02/2015,0,DEP.EFECTIVO 108204077,0,188,1080.50,,364216.92,5865,
03/02/2015,03/02/2015,0,DEP.EFECTIVO 141601016,0,2162,576.50,,364793.42,5866,
03/02/2015,03/02/2015,0,DEP.EFECTIVO 108204010,0,188,689.50,,365482.92,5867,
03/02/2015,03/02/2015,0,ANUL.DEP.EFECTIVO 96824,501,1490,,"$1,151.06",364331.86,5868,
03/02/2015,03/02/2015,0,DEP.EFECTIVO,0,1490,1151.00,,365482.86,5869,
03/02/2015,03/02/2015,0,DEP.EFECTIVO 1133010742,0,1470,5574.00,,371056.86,5870,
03/02/2015,03/02/2015,0,DEP.EFECTIVO 137601017,0,1470,2294.10,,373350.96,5871,
03/02/2015,03/02/2015,0,DEP.EFECTIVO 137601013,0,1470,1090.00,,374440.96,5872,
03/02/2015,03/02/2015,0,DEP.EFECTIVO 1133010679,0,1470,1809.80,,376250.76,5873,
03/02/2015,03/02/2015,0,DEP.EFECTIVO 1133010519,0,1470,2308.50,,378559.26,5874,
03/02/2015,03/02/2015,0,DEP.EFECTIVO 137601015,0,1470,5110.50,,383669.76,5875,
03/02/2015,03/02/2015,0,DEP.EFECTIVO 1133010170,0,1470,1021.00,,384690.76,5876,
03/02/2015,03/02/2015,0,DEP.EFECTIVO 137601019,0,1470,3091.60,,387782.36,5877,
03/02/2015,03/02/2015,0,DEP.EFECTIVO 137601016,0,1470,1347.00,,389129.36,5878,
03/02/2015,03/02/2015,0,DEP.EFECTIVO 102101055,0,1581,1873.50,,391002.86,5879,
03/02/2015,03/02/2015,0,DEP.EFECTIVO 102101014,0,1581,658.50,,391661.36,5880,
03/02/2015,03/02/2015,0,DEP.EFECTIVO 102101071,0,1581,1057.00,,392718.36,5881,
03/02/2015,03/02/2015,0,DEP.EFECTIVO 102101063,0,1581,1819.50,,394537.86,5882,
03/02/2015,03/02/2015,0,DEP.EFECTIVO 104901064,0,463,2049.55,,396587.41,5883,
03/02/2015,03/02/2015,0,DEP.EFECTIVO 104901056,0,463,2054.00,,398641.41,5884,
03/02/2015,03/02/2015,0,DEP.EFECTIVO 104901015,0,463,1055.50,,399696.91,5885,
03/02/2015,03/02/2015,0,DEP.EFECTIVO 104901072,0,463,1077.50,,400774.41,5886,
03/02/2015,03/02/2015,0,DEP.EFECTIVO 121801016,0,2162,883.00,,401657.41,5887,
03/02/2015,03/02/2015,0,DEP.EFECTIVO 121801065,0,2162,636.00,,402293.41,5888,
03/02/2015,03/02/2015,0,DEP.EFECTIVO 121801057,0,2162,1740.00,,404033.41,5889,
03/02/2015,03/02/2015,0,DEP.EFECTIVO 121801073,0,2162,960.50,,404993.91,5890,
03/02/2015,03/02/2015,0,DEP.EFECTIVO 113201019,0,2162,1181.00,,406174.91,5891,
03/02/2015,03/02/2015,0,DEP.EFECTIVO 113201068,0,2162,4664.10,,410839.01,5892,
03/02/2015,03/02/2015,0,DEP.EFECTIVO 113201076,0,2162,1891.00,,412730.01,5893,
03/02/2015,03/02/2015,0,DEP.EFECTIVO 113201050,0,2162,3234.00,,415964.01,5894,
03/02/2015,03/02/2015,0,DEP.EFECTIVO 122201017,0,2162,1616.50,,417580.51,5895,
03/02/2015,03/02/2015,0,DEP.EFECTIVO 122201013,0,2162,2655.50,,420236.01,5896,
03/02/2015,03/02/2015,0,DEP.EFECTIVO 122201016,0,2162,1751.00,,421987.01,5897,
03/02/2015,03/02/2015,0,DEP.EFECTIVO 103409051,0,7461,1079.30,,423066.31,5898,
03/02/2015,03/02/2015,0,DEP.EFECTIVO 122201015,0,2162,2169.50,,425235.81,5899,
03/02/2015,03/02/2015,0,DEP.EFECTIVO 103409010,0,7461,1008.50,,426244.31,5900,
03/02/2015,03/02/2015,0,DEP.EFECTIVO 103409077,0,7461,497.50,,426741.81,5901,
03/02/2015,03/02/2015,0,DEP.EFECTIVO 103409069,0,7461,172.97,,426914.78,5902,
03/02/2015,03/02/2015,0,ANUL.DEP.EFECTIVO,501,1490,,"$2,481.60",424433.18,5903,
03/02/2015,03/02/2015,0,DEP.EFECTIVO 101333014,0,3682,3372.50,,427805.68,5904,
03/02/2015,03/02/2015,0,DEP.EFECTIVO 96824068,0,1490,2481.60,,430287.28,5905,
03/02/2015,03/02/2015,0,DEP.EFECTIVO 101333071,0,3682,1889.00,,432176.28,5906,
03/02/2015,03/02/2015,0,DEP.EFECTIVO 101333063,0,3682,1062.17,,433238.45,5907,
03/02/2015,03/02/2015,0,DEP.EFECTIVO 101333055,0,3682,4474.50,,437712.95,5908,
03/02/2015,03/02/2015,0,ANUL.DEP.EFECTIVO,501,1490,,"$1,151.00",436561.95,5909,
03/02/2015,03/02/2015,0,DEP.EFECTIVO 96824076,0,1490,1151.00,,437712.95,5910,
03/02/2015,03/02/2015,0,DEP.EFECTIVO 123501051,0,2162,1696.00,,439408.95,5911,
03/02/2015,03/02/2015,0,DEP.EFECTIVO 123501069,0,2162,1201.50,,440610.45,5912,
03/02/2015,03/02/2015,0,DEP.EFECTIVO 123501010,0,2162,458.00,,441068.45,5913,
03/02/2015,03/02/2015,0,DEP.EFECTIVO 123501077,0,2162,1134.50,,442202.95,5914,
03/02/2015,03/02/2015,0,DEP.EFECTIVO 99213061,0,20,3632.50,,445835.45,5915,
03/02/2015,03/02/2015,0,DEP.EFECTIVO 99213053,0,20,2198.00,,448033.45,5916,
03/02/2015,03/02/2015,0,DEP.EFECTIVO 112401057,0,8701,2632.50,,450665.95,5917,
03/02/2015,03/02/2015,0,DEP.EFECTIVO 112401065,0,8701,1577.00,,452242.95,5918,
03/02/2015,03/02/2015,0,DEP.EFECTIVO 112401073,0,8701,1445.50,,453688.45,5919,
03/02/2015,03/02/2015,0,DEP.EFECTIVO 112401016,0,8701,1071.50,,454759.95,5920,
04/02/2015,04/02/2015,200,TRASPASO A CUENTA PROPIA,790,8846,,"$454,759.94",0.01,5921,"IVA:00000000.00 , A LA CUENTA 0136679699, 200 AL R.F.C. FTI9211036K2"
04/02/2015,04/02/2015,0,DEP.EFECTIVO 131801022,0,699,4134.50,,4134.51,5922,
04/02/2015,04/02/2015,0,DEP.EFECTIVO 141601024,0,1938,1311.50,,5446.01,5923,
04/02/2015,04/02/2015,0,DEP.EFECTIVO 106414025,0,8014,2659.50,,8105.51,5924,
04/02/2015,04/02/2015,0,DEP.EFECTIVO 110501024,0,8014,5343.50,,13449.01,5925,
04/02/2015,04/02/2015,0,DEP.EFECTIVO,0,706,2454.00,,15903.01,5926,
04/02/2015,04/02/2015,0,DEP.EFECTIVO 126301024,0,464,1963.50,,17866.51,5927,
04/02/2015,04/02/2015,0,DEP.EFECTIVO 137001056,0,2049,0.40,,17866.91,5928,
04/02/2015,04/02/2015,0,DEP.EFECTIVO 137001023,0,2049,874.00,,18740.91,5929,
04/02/2015,04/02/2015,0,DEP.EFECTIVO 099101014,0,1934,6068.00,,24808.91,5930,
04/02/2015,04/02/2015,0,DEP.EFECTIVO 099101016,0,1934,1145.00,,25953.91,5931,
04/02/2015,04/02/2015,0,DEP.EFECTIVO 093001024,0,691,2625.00,,28578.91,5932,
04/02/2015,04/02/2015,0,DEP.EFECTIVO 099101017,0,1934,3772.00,,32350.91,5933,
04/02/2015,04/02/2015,0,DEP.EFECTIVO 099101015,0,1934,3820.00,,36170.91,5934,
04/02/2015,04/02/2015,0,DEP.EFECTIVO 111501022,0,2290,3430.50,,39601.41,5935,
04/02/2015,04/02/2015,0,DEP.EFECTIVO 099101013,0,1934,1402.00,,41003.41,5936,
04/02/2015,04/02/2015,0,DEP.EFECTIVO 100101024,0,2326,2628.00,,43631.41,5937,
04/02/2015,04/02/2015,0,DEP.EFECTIVO 121201027,0,275,1721.00,,45352.41,5938,
04/02/2015,04/02/2015,0,DEP.EFECTIVO 133448020,0,2460,4199.00,,49551.41,5939,
04/02/2015,04/02/2015,0,DEP.EFECTIVO 124601025,0,116,3345.50,,52896.91,5940,
04/02/2015,04/02/2015,0,DEP.EFECTIVO 92508020,0,3630,5640.50,,58537.41,5941,
04/02/2015,04/02/2015,0,DEP.EFECTIVO 124301022,0,1474,2572.50,,61109.91,5942,
04/02/2015,04/02/2015,0,DEP.EFECTIVO 98001012,0,1477,1291.00,,62400.91,5943,
04/02/2015,04/02/2015,0,DEP.EFECTIVO 099301024,0,2325,2078.00,,64478.91,5944,
04/02/2015,04/02/2015,0,DEP.EFECTIVO 141301024,0,2102,927.50,,65406.41,5945,
04/02/2015,04/02/2015,0,DEP.EFECTIVO 122701024,0,2325,1871.00,,67277.41,5946,
04/02/2015,04/02/2015,0,DEP.EFECTIVO 121701026,0,831,1772.50,,69049.91,5947,
04/02/2015,04/02/2015,0,DEP.EFECTIVO 094301024,0,1938,1991.00,,71040.91,5948,
04/02/2015,04/02/2015,0,DEP.EFECTIVO 116501024,0,1424,4473.50,,75514.41,5949,
04/02/2015,04/02/2015,0,DEP.EFECTIVO 33402025,0,52,1231.00,,76745.41,5950,
04/02/2015,04/02/2015,0,DEP.EFECTIVO 35102029,0,52,1339.00,,78084.41,5951,
04/02/2015,04/02/2015,0,DEP.EFECTIVO 041201024,0,2325,4769.00,,82853.41,5952,
04/02/2015,04/02/2015,0,DEP.EFECTIVO 104901023,0,2092,3478.50,,86331.91,5953,
04/02/2015,04/02/2015,0,DEP.EFECTIVO 122201014,0,2069,2259.50,,88591.41,5954,
04/02/2015,04/02/2015,0,DEP.EFECTIVO 119101024,0,2126,2509.50,,91100.91,5955,
04/02/2015,04/02/2015,0,DEP.EFECTIVO 120501024,0,2382,2861.00,,93961.91,5956,
04/02/2015,04/02/2015,0,DEP.EFECTIVO 118701024,0,2314,1903.50,,95865.41,5957,
04/02/2015,04/02/2015,0,DEP.EFECTIVO 098301024,0,2314,4059.50,,99924.91,5958,
04/02/2015,04/02/2015,0,DEP.EFECTIVO 13160102,0,117,3446.00,,103370.91,5959,
04/02/2015,04/02/2015,0,DEP.EFECTIVO 1000300217,0,2552,1877.00,,105247.91,5960,
04/02/2015,04/02/2015,0,DEP.EFECTIVO 96901023,0,2043,2167.50,,107415.41,5961,
04/02/2015,04/02/2015,0,DEP.EFECTIVO 1145300235,0,2552,1981.00,,109396.41,5962,
04/02/2015,04/02/2015,0,DEP.EFECTIVO 112401024,0,8717,762.00,,110158.41,5963,
04/02/2015,04/02/2015,0,DEP.EFECTIVO 91402027,0,727,3634.40,,113792.81,5964,
04/02/2015,04/02/2015,0,DEP.EFECTIVO 101333022,0,3682,3226.70,,117019.51,5965,
04/02/2015,04/02/2015,0,DEP.EFECTIVO 104727029,0,3705,853.00,,117872.51,5966,
04/02/2015,04/02/2015,0,DEP.EFECTIVO 1282030290,0,3190,1767.50,,119640.01,5967,
04/02/2015,04/02/2015,0,DEP.EFECTIVO 150401024,0,2043,3511.00,,123151.01,5968,
04/02/2015,04/02/2015,0,DEP.EFECTIVO 117901028,0,2067,1821.50,,124972.51,5969,
04/02/2015,04/02/2015,0,DEP.EFECTIVO 123601026,0,2306,1668.50,,126641.01,5970,
04/02/2015,04/02/2015,0,DEP.EFECTIVO 129201016,0,295,1201.00,,127842.01,5971,
04/02/2015,04/02/2015,0,DEP.EFECTIVO 141001027,0,116,1683.50,,129525.51,5972,
04/02/2015,04/02/2015,0,DEP.EFECTIVO 96824027,0,716,4135.50,,133661.01,5973,
04/02/2015,04/02/2015,0,DEP.EFECTIVO 133301021,0,274,2517.50,,136178.51,5974,
04/02/2015,04/02/2015,0,DEP.EFECTIVO 1133010233,0,2043,3112.00,,139290.51,5975,
04/02/2015,04/02/2015,0,DEP.EFECTIVO 107701024,0,118,1912.50,,141203.01,5976,
04/02/2015,04/02/2015,0,DEP.EFECTIVO 113201027,0,2331,4973.00,,146176.01,5977,
04/02/2015,04/02/2015,0,DEP.EFECTIVO 99213079,0,648,922.50,,147098.51,5978,
04/02/2015,04/02/2015,0,DEP.EFECTIVO 99213012,0,648,1385.50,,148484.01,5979,
04/02/2015,04/02/2015,0,DEP.EFECTIVO 133201023,0,360,3028.50,,151512.51,5980,
04/02/2015,04/02/2015,0,DEP.EFECTIVO 117101025,0,1334,3137.00,,154649.51,5981,
04/02/2015,04/02/2015,0,DEP.EFECTIVO 119613076,0,7726,753.60,,155403.11,5982,
04/02/2015,04/02/2015,0,DEP.EFECTIVO 119613019,0,7726,822.50,,156225.61,5983,
04/02/2015,04/02/2015,0,DEP.EFECTIVO 117001027,0,274,3274.00,,159499.61,5984,
04/02/2015,04/02/2015,0,DEP.EFECTIVO 119301073,0,1536,922.00,,160421.61,5985,
04/02/2015,04/02/2015,0,DEP.EFECTIVO 095401024,0,295,1753.00,,162174.61,5986,
04/02/2015,04/02/2015,0,DEP.EFECTIVO 111024025,0,1490,1344.00,,163518.61,5987,
04/02/2015,04/02/2015,0,DEP.EFECTIVO 1090100207,0,8114,5563.90,,169082.51,5988,
04/02/2015,04/02/2015,0,DEP.EFECTIVO 108204028,0,188,1492.00,,170574.51,5989,
04/02/2015,04/02/2015,0,DEP.EFECTIVO 1282030639,0,3190,20.00,,170594.51,5990,
04/02/2015,04/02/2015,0,DEP.EFECTIVO,0,8114,3446.00,,174040.51,5991,
04/02/2015,04/02/2015,0,DEP.EFECTIVO 115901020,0,8013,1924.50,,175965.01,5992,
04/02/2015,04/02/2015,0,DEP.EFECTIVO 124901029,0,2104,3535.00,,179500.01,5993,
04/02/2015,04/02/2015,0,DEP.EFECTIVO 123501028,0,2162,2710.00,,182210.01,5994,
04/02/2015,04/02/2015,0,DEP.EFECTIVO 121801024,0,2547,1115.50,,183325.51,5995,
04/02/2015,04/02/2015,0,ANUL.DEP.EFECTIVO,501,8114,,"$3,446.00",179879.51,5996,
04/02/2015,04/02/2015,0,DEP.EFECTIVO 102210021,0,8114,3446.00,,183325.51,5997,
04/02/2015,04/02/2015,0,DEP.EFECTIVO 103409028,0,82,2048.50,,185374.01,5998,
04/02/2015,04/02/2015,0,DEP.EFECTIVO 102914028,0,8015,1617.00,,186991.01,5999,
05/02/2015,05/02/2015,200,TRASPASO A CUENTA PROPIA,790,8846,,"$186,991.00",0.01,6000,"IVA:00000000.00 , A LA CUENTA 0136679699, 200 AL R.F.C. FTI9211036K2"
05/02/2015,05/02/2015,0,DEP.EFECTIVO 160201037,0,2062,6425.00,,6425.01,6001,
05/02/2015,05/02/2015,0,DEP.EFECTIVO 131801030,0,2102,3433.00,,9858.01,6002,
05/02/2015,05/02/2015,0,DEP.EFECTIVO 137001031,0,2049,1406.50,,11264.51,6003,
05/02/2015,05/02/2015,0,DEP.EFECTIVO 34602037,0,52,1922.00,,13186.51,6004,
05/02/2015,05/02/2015,0,DEP.EFECTIVO 100101032,0,2326,4082.00,,17268.51,6005,
05/02/2015,05/02/2015,0,DEP.EFECTIVO 100101032,0,2326,18.00,,17286.51,6006,
05/02/2015,05/02/2015,0,DEP.EFECTIVO 124601033,0,116,2600.50,,19887.01,6007,
05/02/2015,05/02/2015,0,DEP.EFECTIVO 108204036,0,188,2595.50,,22482.51,6008,
05/02/2015,05/02/2015,0,DEP.EFECTIVO 118701032,0,2314,2111.00,,24593.51,6009,
05/02/2015,05/02/2015,0,DEP.EFECTIVO 102914036,0,8015,932.00,,25525.51,6010,
05/02/2015,05/02/2015,0,DEP.EFECTIVO 141301032,0,2102,1008.50,,26534.01,6011,
05/02/2015,05/02/2015,0,DEP.EFECTIVO 111501030,0,2290,2606.00,,29140.01,6012,
05/02/2015,05/02/2015,0,DEP.EFECTIVO 112401032,0,8701,1180.00,,30320.01,6013,
05/02/2015,05/02/2015,0,DEP.EFECTIVO 098301032,0,2314,3494.50,,33814.51,6014,
05/02/2015,05/02/2015,0,DEP.EFECTIVO,0,2069,1844.00,,35658.51,6015,
05/02/2015,05/02/2015,0,DEP.EFECTIVO 92508038,0,3630,5838.00,,41496.51,6016,
05/02/2015,05/02/2015,0,DEP.EFECTIVO 35102037,0,52,1461.50,,42958.01,6017,
05/02/2015,05/02/2015,0,DEP.EFECTIVO 1332201031,0,2183,1501.00,,44459.01,6018,
05/02/2015,05/02/2015,0,DEP.EFECTIVO 33402033,0,52,1656.00,,46115.01,6019,
05/02/2015,05/02/2015,0,DEP.EFECTIVO 96824035,0,1490,4000.00,,50115.01,6020,
05/02/2015,05/02/2015,0,DEP.EFECTIVO 110501032,0,8014,4438.50,,54553.51,6021,
05/02/2015,05/02/2015,0,DEP.EFECTIVO 106414033,0,8014,2546.00,,57099.51,6022,
05/02/2015,05/02/2015,0,DEP.EFECTIVO 124301030,0,1474,2405.00,,59504.51,6023,
05/02/2015,05/02/2015,0,DEP.EFECTIVO 98001020,0,1477,1951.50,,61456.01,6024,
05/02/2015,05/02/2015,0,DEP.EFECTIVO 123601034,0,2306,700.50,,62156.51,6025,
05/02/2015,05/02/2015,0,DEP.EFECTIVO 91402035,0,727,2052.60,,64209.11,6026,
05/02/2015,05/02/2015,0,DEP.EFECTIVO 117101033,0,1334,4113.50,,68322.61,6027,
05/02/2015,05/02/2015,0,DEP.EFECTIVO 111024033,0,1490,2920.00,,71242.61,6028,
05/02/2015,05/02/2015,0,DEP.EFECTIVO 133448038,0,2460,1995.50,,73238.11,6029,
05/02/2015,05/02/2015,0,DEP.EFECTIVO 041201032,0,2325,3997.00,,77235.11,6030,
05/02/2015,05/02/2015,0,DEP.EFECTIVO 150401032,0,2043,4380.00,,81615.11,6031,
05/02/2015,05/02/2015,0,DEP.EFECTIVO 099301032,0,2325,1542.00,,83157.11,6032,
05/02/2015,05/02/2015,0,DEP.EFECTIVO 122701032,0,2325,1561.00,,84718.11,6033,
05/02/2015,05/02/2015,0,DEP.EFECTIVO 121701034,0,831,1952.70,,86670.81,6034,
05/02/2015,05/02/2015,0,DEP.EFECTIVO 1000300377,0,2552,2559.00,,89229.81,6035,
05/02/2015,05/02/2015,0,DEP.EFECTIVO 119101032,0,2126,2095.00,,91324.81,6036,
05/02/2015,05/02/2015,0,DEP.EFECTIVO 094301032,0,1938,2455.50,,93780.31,6037,
05/02/2015,05/02/2015,0,DEP.EFECTIVO 96901031,0,2043,2309.50,,96089.81,6038,
05/02/2015,05/02/2015,0,DEP.EFECTIVO 1145300395,0,2552,1789.00,,97878.81,6039,
05/02/2015,05/02/2015,0,DEP.EFECTIVO 117513021,0,1566,3167.80,,101046.61,6040,
05/02/2015,05/02/2015,0,DEP.EFECTIVO 91402027,0,727,100.00,,101146.61,6041,
05/02/2015,05/02/2015,0,DEP.EFECTIVO 141001035,0,2009,1625.00,,102771.61,6042,
05/02/2015,05/02/2015,0,DEP.EFECTIVO 104727037,0,3705,1225.00,,103996.61,6043,
05/02/2015,05/02/2015,0,DEP.EFECTIVO 13160103,0,691,3420.50,,107417.11,6044,
05/02/2015,05/02/2015,0,DEP.EFECTIVO 131013073,0,166,990.50,,108407.61,6045,
05/02/2015,05/02/2015,0,DEP.EFECTIVO 131013016,0,166,451.50,,108859.11,6046,
05/02/2015,05/02/2015,0,DEP.EFECTIVO 117001035,0,274,2083.50,,110942.61,6047,
05/02/2015,05/02/2015,0,DEP.EFECTIVO 101333030,0,3682,3169.50,,114112.11,6048,
05/02/2015,05/02/2015,0,DEP.EFECTIVO 116501032,0,1424,3944.10,,118056.21,6049,
05/02/2015,05/02/2015,0,DEP.EFECTIVO 1209130779,0,1536,1033.00,,119089.21,6050,
05/02/2015,05/02/2015,0,DEP.EFECTIVO 1282030353,0,3190,1773.50,,120862.71,6051,
05/02/2015,05/02/2015,0,DEP.EFECTIVO 093001024,0,691,1000.00,,121862.71,6052,
05/02/2015,05/02/2015,0,DEP.EFECTIVO 093001032,0,691,2337.00,,124199.71,6053,
05/02/2015,05/02/2015,0,DEP.EFECTIVO 117901036,0,2067,1113.00,,125312.71,6054,
05/02/2015,05/02/2015,0,DEP.EFECTIVO 120501032,0,2325,2750.00,,128062.71,6055,
05/02/2015,05/02/2015,0,DEP.EFECTIVO 113201035,0,2331,3362.00,,131424.71,6056,
05/02/2015,05/02/2015,0,DEP.EFECTIVO 102101030,0,1581,1972.50,,133397.21,6057,
05/02/2015,05/02/2015,0,DEP.EFECTIVO 124901037,0,2104,3649.00,,137046.21,6058,
05/02/2015,05/02/2015,0,DEP.EFECTIVO 1114130264,0,1974,2980.50,,140026.71,6059,
05/02/2015,05/02/2015,0,DEP.EFECTIVO 1133010393,0,2043,3189.00,,143215.71,6060,
05/02/2015,05/02/2015,0,DEP.EFECTIVO 103409036,0,7461,1047.00,,144262.71,6061,
05/02/2015,05/02/2015,0,DEP.EFECTIVO 107701032,0,2113,3019.50,,147282.21,6062,
05/02/2015,05/02/2015,0,DEPOSITO DE CUENTA DE TERCEROS,0,4253,1263.40,,148545.61,6063,"DEPOSITO EFECTIVO OFICINA TELECOMM 30035, REFERENCIA CLIENTE 0000000000"
05/02/2015,05/02/2015,0,DEPOSITO DE CUENTA DE TERCEROS,0,4253,1437.30,,149982.91,6064,"DEPOSITO EFECTIVO OFICINA TELECOMM 30035, REFERENCIA CLIENTE 0000000000"
05/02/2015,05/02/2015,0,DEP.EFECTIVO 121201035,0,275,1805.00,,151787.91,6065,
05/02/2015,05/02/2015,0,DEP.EFECTIVO 141601032,0,1938,827.00,,152614.91,6066,
05/02/2015,05/02/2015,0,DEP.EFECTIVO 119301024,0,1536,464.00,,153078.91,6067,
05/02/2015,05/02/2015,0,DEP.EFECTIVO 1090100367,0,8113,5467.90,,158546.81,6068,
05/02/2015,05/02/2015,0,DEP.EFECTIVO 119301016,0,1536,1045.50,,159592.31,6069,
05/02/2015,05/02/2015,0,DEP.EFECTIVO 126301032,0,464,2684.00,,162276.31,6070,
05/02/2015,05/02/2015,0,DEP.EFECTIVO 133301039,0,3,3312.50,,165588.81,6071,
05/02/2015,05/02/2015,0,DEP.EFECTIVO 115901038,0,8013,1551.00,,167139.81,6072,
05/02/2015,05/02/2015,0,DEP.EFECTIVO 123501036,0,2104,1457.00,,168596.81,6073,
05/02/2015,05/02/2015,0,DEP.EFECTIVO 121201035,0,275,20.00,,168616.81,6074,
05/02/2015,05/02/2015,0,DEP.EFECTIVO 129201012,0,295,2333.50,,170950.31,6075,
05/02/2015,05/02/2015,0,DEP.EFECTIVO 095401032,0,295,1676.50,,172626.81,6076,
05/02/2015,05/02/2015,0,DEP.EFECTIVO 09910102,0,1934,3880.00,,176506.81,6077,
05/02/2015,05/02/2015,0,DEP.EFECTIVO 102210039,0,8114,2924.50,,179431.31,6078,
05/02/2015,05/02/2015,0,DEP.EFECTIVO 108301016,0,3682,11691.60,,191122.91,6079,
05/02/2015,05/02/2015,0,DEP.EFECTIVO 108301024,0,3682,9784.50,,200907.41,6080,
05/02/2015,05/02/2015,0,DEP.EFECTIVO 108301032,0,3682,2156.40,,203063.81,6081,
05/02/2015,05/02/2015,0,DEP.EFECTIVO 137601014,0,1470,4292.00,,207355.81,6082,
05/02/2015,05/02/2015,0,DEP.EFECTIVO 137601012,0,1470,3338.20,,210694.01,6083,
05/02/2015,05/02/2015,0,DEP.EFECTIVO 104901031,0,2092,1426.50,,212120.51,6084,
05/02/2015,05/02/2015,0,DEP.EFECTIVO 121801032,0,2547,927.50,,213048.01,6085,
06/02/2015,06/02/2015,0,DEP.EFECTIVO 118701049,0,2314,1924.00,,214972.01,6086,
06/02/2015,06/02/2015,0,DEP.EFECTIVO 098301049,0,2314,2579.00,,217551.01,6087,
06/02/2015,06/02/2015,0,DEP.EFECTIVO 160201045,0,2062,6532.06,,224083.07,6088,
06/02/2015,06/02/2015,200,TRASPASO A CUENTA PROPIA,790,8846,,"$217,551.00",6532.07,6089,"IVA:00000000.00 , A LA CUENTA 0136679699, 200 AL R.F.C. FTI9211036K2"
06/02/2015,06/02/2015,0,DEP.EFECTIVO 108204044,0,188,3337.50,,9869.57,6090,
06/02/2015,06/02/2015,0,DEP.EFECTIVO 131801048,0,2102,3709.00,,13578.57,6091,
06/02/2015,06/02/2015,0,DEP.EFECTIVO 102101048,0,706,2374.50,,15953.07,6092,
06/02/2015,06/02/2015,0,DEP.EFECTIVO 111501048,0,2290,2738.00,,18691.07,6093,
06/02/2015,06/02/2015,0,DEP.EFECTIVO 141301049,0,2102,921.00,,19612.07,6094,
06/02/2015,06/02/2015,0,DEP.EFECTIVO 124601041,0,116,4077.00,,23689.07,6095,
06/02/2015,06/02/2015,0,DEP.EFECTIVO 117513039,0,1566,5372.50,,29061.57,6096,
06/02/2015,06/02/2015,0,DEP.EFECTIVO 124901045,0,2104,3028.50,,32090.07,6097,
06/02/2015,06/02/2015,0,DEP.EFECTIVO 133448046,0,2460,2355.50,,34445.57,6098,
06/02/2015,06/02/2015,0,DEP.EFECTIVO 137001049,0,2049,1023.50,,35469.07,6099,
06/02/2015,06/02/2015,0,DEP.EFECTIVO 121201050,0,275,2026.50,,37495.57,6100,
06/02/2015,06/02/2015,0,DEP.EFECTIVO 116501049,0,1424,3349.00,,40844.57,6101,
06/02/2015,06/02/2015,0,DEP.EFECTIVO 141601049,0,1938,1597.50,,42442.07,6102,
06/02/2015,06/02/2015,0,DEP.EFECTIVO,0,20,725.00,,43167.07,6103,
06/02/2015,06/02/2015,0,ANUL.DEP.EFECTIVO,501,20,,$725.00,42442.07,6104,
06/02/2015,06/02/2015,0,DEP.EFECTIVO 131013024,0,20,725.00,,43167.07,6105,
06/02/2015,06/02/2015,0,DEP.EFECTIVO 133201049,0,2183,1962.50,,45129.57,6106,
06/02/2015,06/02/2015,0,DEP.EFECTIVO 123601042,0,2306,1633.50,,46763.07,6107,
06/02/2015,06/02/2015,0,DEP.EFECTIVO 041201049,0,2325,2878.00,,49641.07,6108,
06/02/2015,06/02/2015,0,DEP.EFECTIVO 96824043,0,1490,3972.00,,53613.07,6109,
06/02/2015,06/02/2015,0,DEP.EFECTIVO 111024041,0,1490,1998.50,,55611.57,6110,
06/02/2015,06/02/2015,0,DEP.EFECTIVO 121701042,0,831,2461.50,,58073.07,6111,
06/02/2015,06/02/2015,0,DEP.EFECTIVO 124301048,0,1474,2377.00,,60450.07,6112,
06/02/2015,06/02/2015,0,DEP.EFECTIVO 1282030416,0,3190,1045.50,,61495.57,6113,
06/02/2015,06/02/2015,0,DEP.EFECTIVO 91402043,0,727,2185.00,,63680.57,6114,
06/02/2015,06/02/2015,0,DEP.EFECTIVO 150401040,0,2043,3606.00,,67286.57,6115,
06/02/2015,06/02/2015,0,DEP.EFECTIVO 1133010456,0,2043,3132.50,,70419.07,6116,
06/02/2015,06/02/2015,0,DEP.EFECTIVO 133201049,0,2183,20.00,,70439.07,6117,
06/02/2015,06/02/2015,0,DEP.EFECTIVO 117001043,0,274,4010.50,,74449.57,6118,
06/02/2015,06/02/2015,0,DEP.EFECTIVO 13160104,0,117,2999.50,,77449.07,6119,
06/02/2015,06/02/2015,0,DEP.EFECTIVO 123501044,0,2104,1469.50,,78918.57,6120,
06/02/2015,06/02/2015,0,DEP.EFECTIVO 100300440,0,2552,1519.00,,80437.57,6121,
06/02/2015,06/02/2015,0,DEP.EFECTIVO 094301049,0,1938,2614.00,,83051.57,6122,
06/02/2015,06/02/2015,0,DEP.EFECTIVO 34602045,0,143,1748.50,,84800.07,6123,
06/02/2015,06/02/2015,0,DEP.EFECTIVO 1145300458,0,2552,1455.50,,86255.57,6124,
06/02/2015,06/02/2015,0,DEP.EFECTIVO 120501049,0,2382,2567.00,,88822.57,6125,
06/02/2015,06/02/2015,0,DEP.EFECTIVO 33402041,0,52,1672.00,,90494.57,6126,
06/02/2015,06/02/2015,0,DEP.EFECTIVO 101333048,0,3682,5318.00,,95812.57,6127,
06/02/2015,06/02/2015,0,DEP.EFECTIVO 35102045,0,52,1360.00,,97172.57,6128,
06/02/2015,06/02/2015,0,DEP.EFECTIVO 102914044,0,8015,1966.50,,99139.07,6129,
06/02/2015,06/02/2015,0,DEP.EFECTIVO 96901049,0,2043,1899.50,,101038.57,6130,
06/02/2015,06/02/2015,0,DEPOSITO DE CUENTA DE TERCEROS,0,4253,1509.20,,102547.77,6131,"DEPOSITO EFECTIVO OFICINA TELECOMM 30035, REFERENCIA CLIENTE 0000000000"
06/02/2015,06/02/2015,0,DEP.EFECTIVO 126301049,0,464,2917.00,,105464.77,6132,
06/02/2015,06/02/2015,0,DEP.EFECTIVO 100101040,0,2326,3247.00,,108711.77,6133,
06/02/2015,06/02/2015,0,DEP.EFECTIVO 117101041,0,700,2475.50,,111187.27,6134,
06/02/2015,06/02/2015,0,DEP.EFECTIVO 103409044,0,7450,928.00,,112115.27,6135,
06/02/2015,06/02/2015,0,DEP.EFECTIVO 141001043,0,2009,1936.00,,114051.27,6136,
06/02/2015,06/02/2015,0,DEP.EFECTIVO 107701040,0,2113,1940.50,,115991.77,6137,
06/02/2015,06/02/2015,0,DEP.EFECTIVO 099301049,0,2325,1851.00,,117842.77,6138,
06/02/2015,06/02/2015,0,DEP.EFECTIVO 122701049,0,2325,1782.00,,119624.77,6139,
06/02/2015,06/02/2015,0,DEP.EFECTIVO 122201019,0,2069,2293.00,,121917.77,6140,
06/02/2015,06/02/2015,0,DEP.EFECTIVO 92508046,0,3630,4619.50,,126537.27,6141,
06/02/2015,06/02/2015,0,DEP.EFECTIVO 117901044,0,2067,1713.50,,128250.77,6142,
06/02/2015,06/02/2015,0,DEP.EFECTIVO 108301049,0,3682,2443.00,,130693.77,6143,
06/02/2015,06/02/2015,0,DEP.EFECTIVO 104727045,0,3705,1335.50,,132029.27,6144,
06/02/2015,06/02/2015,0,DEP.EFECTIVO 1090100430,0,8113,3640.80,,135670.07,6145,
06/02/2015,06/02/2015,0,DEP.EFECTIVO 133301047,0,3,2798.00,,138468.07,6146,
06/02/2015,06/02/2015,0,DEP.EFECTIVO,0,691,3395.50,,141863.57,6147,
06/02/2015,06/02/2015,0,DEP.EFECTIVO 102210047,0,8114,2924.50,,144788.07,6148,
06/02/2015,06/02/2015,0,DEP.EFECTIVO 115901046,0,8013,765.00,,145553.07,6149,
06/02/2015,06/02/2015,0,DEP.EFECTIVO 119101049,0,464,1982.00,,147535.07,6150,
06/02/2015,06/02/2015,0,DEP.EFECTIVO 113201043,0,2331,2760.00,,150295.07,6151,
06/02/2015,06/02/2015,0,DEP.EFECTIVO 099101019,0,1934,3384.00,,153679.07,6152,
06/02/2015,06/02/2015,0,DEP.EFECTIVO 104901049,0,2092,3794.50,,157473.57,6153,
06/02/2015,06/02/2015,0,DEP.EFECTIVO 137601019,0,1470,1988.70,,159462.27,6154,
06/02/2015,06/02/2015,0,DEP.EFECTIVO 121801040,0,2433,1587.50,,161049.77,6155,
06/02/2015,06/02/2015,0,DEP.EFECTIVO 112401049,0,8717,1350.00,,162399.77,6156,
07/02/2015,09/02/2015,0,DEP.EFECTIVO 108204051,0,188,2448.50,,164848.27,6157,
07/02/2015,09/02/2015,0,DEP.EFECTIVO 133448053,0,2460,1253.50,,166101.77,6158,
07/02/2015,09/02/2015,0,DEP.EFECTIVO 1209130270,0,1536,1193.00,,167294.77,6159,
07/02/2015,09/02/2015,0,DEP.EFECTIVO 1209130110,0,1536,880.50,,168175.27,6160,
07/02/2015,09/02/2015,0,DEP.EFECTIVO 111024058,0,1490,1850.50,,170025.77,6161,
07/02/2015,09/02/2015,0,DEP.EFECTIVO 117513047,0,1566,3075.50,,173101.27,6162,
07/02/2015,09/02/2015,0,DEP.EFECTIVO 116501057,0,1424,4322.60,,177423.87,6163,
09/02/2015,09/02/2015,0,DEP.EFECTIVO 137001056,0,2049,1340.00,,178763.87,6164,
09/02/2015,09/02/2015,0,DEP.EFECTIVO 137001064,0,2049,745.50,,179509.37,6165,
09/02/2015,09/02/2015,0,DEP.EFECTIVO 102101071,0,706,678.00,,180187.37,6166,
09/02/2015,09/02/2015,0,DEP.EFECTIVO 102101063,0,706,2235.50,,182422.87,6167,
09/02/2015,09/02/2015,0,DEP.EFECTIVO 102101055,0,706,2513.00,,184935.87,6168,
09/02/2015,09/02/2015,0,DEP.EFECTIVO 098301057,0,2314,2301.50,,187237.37,6169,
09/02/2015,09/02/2015,0,DEP.EFECTIVO 098301073,0,2314,1840.00,,189077.37,6170,
09/02/2015,09/02/2015,0,DEP.EFECTIVO 098301065,0,2314,2715.50,,191792.87,6171,
09/02/2015,09/02/2015,0,DEP.EFECTIVO 118701073,0,2314,1752.50,,193545.37,6172,
09/02/2015,09/02/2015,0,DEP.EFECTIVO 118701065,0,2314,3727.00,,197272.37,6173,
09/02/2015,09/02/2015,0,DEP.EFECTIVO 118701057,0,2314,2327.50,,199599.87,6174,
09/02/2015,09/02/2015,200,TRASPASO A CUENTA PROPIA,790,8846,,"$199,599.86",0.01,6175,"IVA:00000000.00 , A LA CUENTA 0136679699, 200 AL R.F.C. FTI9211036K2"
09/02/2015,09/02/2015,0,DEP.EFECTIVO 106414041,0,8014,2079.70,,2079.71,6176,
09/02/2015,09/02/2015,0,DEP.EFECTIVO 106414058,0,8014,2187.00,,4266.71,6177,
09/02/2015,09/02/2015,0,DEP.EFECTIVO 106414066,0,8014,1779.20,,6045.91,6178,
09/02/2015,09/02/2015,0,DEP.EFECTIVO 160201078,0,2062,3162.17,,9208.08,6179,
09/02/2015,09/02/2015,0,DEP.EFECTIVO 106414074,0,8014,2803.50,,12011.58,6180,
09/02/2015,09/02/2015,0,DEP.EFECTIVO 160201060,0,2062,3817.59,,15829.17,6181,
09/02/2015,09/02/2015,0,DEP.EFECTIVO 110501049,0,8014,4071.00,,19900.17,6182,
09/02/2015,09/02/2015,0,DEP.EFECTIVO 160201052,0,2062,6099.23,,25999.40,6183,
09/02/2015,09/02/2015,0,DEP.EFECTIVO 131801071,0,2102,2077.00,,28076.40,6184,
09/02/2015,09/02/2015,0,DEP.EFECTIVO 131801063,0,2102,4090.00,,32166.40,6185,
09/02/2015,09/02/2015,0,DEP.EFECTIVO 131801055,0,2102,4214.00,,36380.40,6186,
09/02/2015,09/02/2015,0,DEP.EFECTIVO 141301073,0,2102,191.00,,36571.40,6187,
09/02/2015,09/02/2015,0,DEP.EFECTIVO 141301065,0,2102,546.00,,37117.40,6188,
09/02/2015,09/02/2015,0,DEP.EFECTIVO 141301057,0,2102,701.00,,37818.40,6189,
09/02/2015,09/02/2015,0,DEP.EFECTIVO 1209130333,0,1536,1609.50,,39427.90,6190,
09/02/2015,09/02/2015,0,DEP.EFECTIVO 1209130493,0,1536,697.00,,40124.90,6191,
09/02/2015,09/02/2015,0,DEP.EFECTIVO,0,8114,613.50,,40738.40,6192,
09/02/2015,09/02/2015,0,DEP.EFECTIVO 102210062,0,8114,2162.50,,42900.90,6193,
09/02/2015,09/02/2015,0,DEP.EFECTIVO 102210054,0,8114,2684.00,,45584.90,6194,
09/02/2015,09/02/2015,0,DEP.EFECTIVO 1114130327,0,1974,1500.00,,47084.90,6195,
09/02/2015,09/02/2015,0,DEP.EFECTIVO 1114130487,0,1974,1910.00,,48994.90,6196,
09/02/2015,09/02/2015,0,DEP.EFECTIVO 101333055,0,3682,4062.50,,53057.40,6197,
09/02/2015,09/02/2015,0,DEP.EFECTIVO 1114130550,0,1974,1159.50,,54216.90,6198,
09/02/2015,09/02/2015,0,DEP.EFECTIVO 101333071,0,3682,2411.00,,56627.90,6199,
09/02/2015,09/02/2015,0,DEP.EFECTIVO 1114130613,0,1974,1947.80,,58575.70,6200,
09/02/2015,09/02/2015,0,DEP.EFECTIVO 101333063,0,3682,2648.00,,61223.70,6201,
09/02/2015,09/02/2015,0,DEP.EFECTIVO 108204069,0,188,2048.10,,63271.80,6202,
09/02/2015,09/02/2015,0,DEP.EFECTIVO 124301055,0,1474,2070.50,,65342.30,6203,
09/02/2015,09/02/2015,0,DEP.EFECTIVO 124301063,0,1474,2800.50,,68142.80,6204,
09/02/2015,09/02/2015,0,DEP.EFECTIVO 124301071,0,1474,1793.00,,69935.80,6205,
09/02/2015,09/02/2015,0,DEP.EFECTIVO 102210062,0,8114,450.00,,70385.80,6206,
09/02/2015,09/02/2015,0,DEP.EFECTIVO 108204077,0,188,1460.00,,71845.80,6207,
09/02/2015,09/02/2015,0,DEP.EFECTIVO 117513062,0,1508,4454.00,,76299.80,6208,
09/02/2015,09/02/2015,0,DEP.EFECTIVO 117513054,0,1508,3083.50,,79383.30,6209,
09/02/2015,09/02/2015,0,DEP.EFECTIVO 102914051,0,8015,1469.00,,80852.30,6210,
09/02/2015,09/02/2015,0,DEP.EFECTIVO 102914069,0,8015,1135.50,,81987.80,6211,
09/02/2015,09/02/2015,0,DEP.EFECTIVO 102914077,0,8015,1212.50,,83200.30,6212,
09/02/2015,09/02/2015,0,DEP.EFECTIVO 1282030639,0,3190,1318.50,,84518.80,6213,
09/02/2015,09/02/2015,0,DEP.EFECTIVO 1282030576,0,3190,2136.50,,86655.30,6214,
09/02/2015,09/02/2015,0,DEP.EFECTIVO 1282030799,0,3190,2429.50,,89084.80,6215,
09/02/2015,09/02/2015,0,DEP.EFECTIVO 111501063,0,2290,3216.00,,92300.80,6216,
09/02/2015,09/02/2015,0,DEP.EFECTIVO 111501055,0,2290,2939.50,,95240.30,6217,
09/02/2015,09/02/2015,0,DEP.EFECTIVO 111501071,0,2290,2934.50,,98174.80,6218,
09/02/2015,09/02/2015,0,DEP.EFECTIVO 099101015,0,1934,4379.00,,102553.80,6219,
09/02/2015,09/02/2015,0,DEP.EFECTIVO 099101013,0,1934,1107.00,,103660.80,6220,
09/02/2015,09/02/2015,0,DEP.EFECTIVO 92508079,0,3630,3163.00,,106823.80,6221,
09/02/2015,09/02/2015,0,DEP.EFECTIVO 92508053,0,3630,3991.50,,110815.30,6222,
09/02/2015,09/02/2015,0,DEP.EFECTIVO 92508061,0,3630,4471.00,,115286.30,6223,
09/02/2015,09/02/2015,0,DEP.EFECTIVO 108301057,0,3682,2262.00,,117548.30,6224,
09/02/2015,09/02/2015,0,DEP.EFECTIVO 108301065,0,3682,1405.50,,118953.80,6225,
09/02/2015,09/02/2015,0,DEP.EFECTIVO 108301073,0,3682,1462.30,,120416.10,6226,
09/02/2015,09/02/2015,0,DEP.EFECTIVO 124601074,0,116,1855.00,,122271.10,6227,
09/02/2015,09/02/2015,0,DEP.EFECTIVO 124601066,0,116,2292.00,,124563.10,6228,
09/02/2015,09/02/2015,0,DEP.EFECTIVO 124601058,0,116,2894.00,,127457.10,6229,
09/02/2015,09/02/2015,0,DEP.EFECTIVO 104727060,0,3705,3452.00,,130909.10,6230,
09/02/2015,09/02/2015,0,DEP.EFECTIVO 104727078,0,3705,903.50,,131812.60,6231,
09/02/2015,09/02/2015,0,DEP.EFECTIVO 117901051,0,2067,1100.50,,132913.10,6232,
09/02/2015,09/02/2015,0,DEP.EFECTIVO 104727052,0,3705,782.50,,133695.60,6233,
09/02/2015,10/02/2015,0,CHQ.LOCAL 008423 104727052,6,3705,1555.00,,135250.60,6234,BCO :0044 CTA. 0000103273423 NO.CHEQUE 0000008423
09/02/2015,09/02/2015,0,DEP.EFECTIVO 117901069,0,2067,2985.00,,138235.60,6235,
09/02/2015,09/02/2015,0,DEP.EFECTIVO 117901077,0,2067,1663.50,,139899.10,6236,
09/02/2015,09/02/2015,0,DEP.EFECTIVO 121201050,0,275,1604.50,,141503.60,6237,
09/02/2015,09/02/2015,0,DEP.EFECTIVO,0,2069,3057.00,,144560.60,6238,
09/02/2015,09/02/2015,0,DEP.EFECTIVO 121201068,0,275,1971.00,,146531.60,6239,
09/02/2015,09/02/2015,0,DEP.EFECTIVO 121201076,0,275,754.00,,147285.60,6240,
09/02/2015,09/02/2015,0,DEP.EFECTIVO 133448061,0,2460,2325.00,,149610.60,6241,
09/02/2015,09/02/2015,0,DEP.EFECTIVO 133448079,0,2460,484.00,,150094.60,6242,
09/02/2015,09/02/2015,0,ANUL.DEP.EFECTIVO,501,2069,,"$3,057.00",147037.60,6243,
09/02/2015,09/02/2015,0,DEP.EFECTIVO 122201013,0,2069,3057.00,,150094.60,6244,
09/02/2015,09/02/2015,0,DEP.EFECTIVO 122201017,0,2069,1983.50,,152078.10,6245,
09/02/2015,09/02/2015,0,DEP.EFECTIVO 122201015,0,2069,2586.00,,154664.10,6246,
09/02/2015,10/02/2015,0,CHQ.LOCAL 016317 35102078,6,52,130.00,,154794.10,6247,BCO :0044 CTA. 0014504659449 NO.CHEQUE 0000016317
09/02/2015,09/02/2015,0,DEP.EFECTIVO 35102078,0,52,1517.00,,156311.10,6248,
09/02/2015,09/02/2015,0,ANUL.DEP.EFECTIVO,501,8114,,$613.50,155697.60,6249,
09/02/2015,09/02/2015,0,DEP.EFECTIVO 35102052,0,52,2309.00,,158006.60,6250,
09/02/2015,09/02/2015,0,DEP.EFECTIVO 35102060,0,52,3108.60,,161115.20,6251,
09/02/2015,09/02/2015,0,DEP.EFECTIVO 102210070,0,8114,613.50,,161728.70,6252,
09/02/2015,09/02/2015,0,DEP.EFECTIVO 33402074,0,52,1582.50,,163311.20,6253,
09/02/2015,09/02/2015,0,DEP.EFECTIVO 33402066,0,52,2827.70,,166138.90,6254,
09/02/2015,09/02/2015,0,DEP.EFECTIVO 100101057,0,2326,2245.00,,168383.90,6255,
09/02/2015,09/02/2015,0,DEP.EFECTIVO 33402058,0,52,2084.00,,170467.90,6256,
09/02/2015,09/02/2015,0,DEP.EFECTIVO 100101065,0,2326,2366.00,,172833.90,6257,
09/02/2015,09/02/2015,0,DEP.EFECTIVO 094301073,0,1938,1097.00,,173930.90,6258,
09/02/2015,09/02/2015,0,DEP.EFECTIVO 100101073,0,2326,2743.00,,176673.90,6259,
09/02/2015,09/02/2015,0,DEP.EFECTIVO 133201056,0,2183,2333.50,,179007.40,6260,
09/02/2015,09/02/2015,0,DEP.EFECTIVO 094301065,0,1938,2734.50,,181741.90,6261,
09/02/2015,09/02/2015,0,DEP.EFECTIVO 133201064,0,2183,1112.50,,182854.40,6262,
09/02/2015,09/02/2015,0,DEP.EFECTIVO 094301057,0,1938,2624.50,,185478.90,6263,
09/02/2015,09/02/2015,0,DEP.EFECTIVO 133201072,0,2183,861.50,,186340.40,6264,
09/02/2015,09/02/2015,0,DEP.EFECTIVO 141001068,0,2009,1445.50,,187785.90,6265,
09/02/2015,09/02/2015,0,DEP.EFECTIVO 141001076,0,2009,1468.00,,189253.90,6266,
09/02/2015,09/02/2015,0,DEP.EFECTIVO 34602060,0,52,1794.00,,191047.90,6267,
09/02/2015,09/02/2015,0,DEP.EFECTIVO 141001050,0,2009,982.50,,192030.40,6268,
09/02/2015,09/02/2015,0,DEP.EFECTIVO 141601057,0,1938,1302.50,,193332.90,6269,
09/02/2015,09/02/2015,0,DEP.EFECTIVO 99213020,0,648,2965.80,,196298.70,6270,
09/02/2015,09/02/2015,0,DEP.EFECTIVO 34602078,0,52,1525.00,,197823.70,6271,
09/02/2015,09/02/2015,0,DEP.EFECTIVO 99213038,0,648,2403.00,,200226.70,6272,
09/02/2015,09/02/2015,0,DEP.EFECTIVO 141601073,0,1938,648.50,,200875.20,6273,
09/02/2015,09/02/2015,0,DEP.EFECTIVO 91402050,0,727,1215.00,,202090.20,6274,
09/02/2015,09/02/2015,0,DEP.EFECTIVO 34602052,0,52,1319.00,,203409.20,6275,
09/02/2015,09/02/2015,0,DEP.EFECTIVO 141601065,0,1938,488.50,,203897.70,6276,
09/02/2015,09/02/2015,0,DEP.EFECTIVO 99213046,0,648,3101.50,,206999.20,6277,
09/02/2015,09/02/2015,0,DEP.EFECTIVO 91402076,0,727,1487.20,,208486.40,6278,
09/02/2015,09/02/2015,0,DEP.EFECTIVO 99213053,0,648,2477.50,,210963.90,6279,
09/02/2015,09/02/2015,0,DEP.EFECTIVO 91402068,0,727,2767.85,,213731.75,6280,
09/02/2015,09/02/2015,0,DEP.EFECTIVO 96824050,0,1490,3990.50,,217722.25,6281,
09/02/2015,09/02/2015,0,DEP.EFECTIVO 96824068,0,1490,3762.00,,221484.25,6282,
09/02/2015,09/02/2015,0,DEP.EFECTIVO 123601067,0,2306,1680.50,,223164.75,6283,
09/02/2015,09/02/2015,0,DEP.EFECTIVO 96824076,0,1490,562.50,,223727.25,6284,
09/02/2015,09/02/2015,0,DEP.EFECTIVO 111024074,0,1490,1466.00,,225193.25,6285,
09/02/2015,09/02/2015,0,DEP.EFECTIVO 123601075,0,2306,1043.50,,226236.75,6286,
09/02/2015,09/02/2015,0,DEP.EFECTIVO 111024066,0,1490,1376.50,,227613.25,6287,
09/02/2015,09/02/2015,0,DEP.EFECTIVO 1000300726,0,2552,1355.00,,228968.25,6288,
09/02/2015,09/02/2015,0,DEP.EFECTIVO 1000300503,0,2552,2282.00,,231250.25,6289,
09/02/2015,09/02/2015,0,DEP.EFECTIVO 041201073,0,2325,2166.50,,233416.75,6290,
09/02/2015,09/02/2015,0,DEP.EFECTIVO 1000300663,0,2552,1436.50,,234853.25,6291,
09/02/2015,09/02/2015,0,DEP.EFECTIVO 041201065,0,2325,3314.00,,238167.25,6292,
09/02/2015,09/02/2015,0,DEP.EFECTIVO 123601059,0,2306,1511.50,,239678.75,6293,
09/02/2015,09/02/2015,0,DEP.EFECTIVO 041201057,0,2325,3891.00,,243569.75,6294,
09/02/2015,09/02/2015,0,DEP.EFECTIVO 120501057,0,2325,3066.00,,246635.75,6295,
09/02/2015,09/02/2015,0,DEP.EFECTIVO 121701059,0,831,1729.50,,248365.25,6296,
09/02/2015,09/02/2015,0,DEP.EFECTIVO 1145300681,0,2552,1434.50,,249799.75,6297,
09/02/2015,09/02/2015,0,DEP.EFECTIVO 121701067,0,831,1017.00,,250816.75,6298,
09/02/2015,09/02/2015,0,DEP.EFECTIVO 1133010742,0,2043,4751.00,,255567.75,6299,
09/02/2015,09/02/2015,0,DEP.EFECTIVO 121701075,0,831,1021.50,,256589.25,6300,
09/02/2015,09/02/2015,0,DEP.EFECTIVO 120501065,0,2325,3149.50,,259738.75,6301,
09/02/2015,09/02/2015,0,DEP.EFECTIVO 1145300744,0,2552,1190.50,,260929.25,6302,
09/02/2015,09/02/2015,0,DEP.EFECTIVO 13160106,0,117,4532.00,,265461.25,6303,
09/02/2015,09/02/2015,0,DEP.EFECTIVO 120501073,0,2325,1558.00,,267019.25,6304,
09/02/2015,09/02/2015,0,DEP.EFECTIVO 1133010519,0,2043,3308.50,,270327.75,6305,
09/02/2015,09/02/2015,0,DEP.EFECTIVO 1145300521,0,2552,1751.50,,272079.25,6306,
09/02/2015,09/02/2015,0,DEP.EFECTIVO 13160107,0,117,2867.50,,274946.75,6307,
09/02/2015,09/02/2015,0,DEP.EFECTIVO 137601013,0,1470,2727.00,,277673.75,6308,
09/02/2015,09/02/2015,0,DEP.EFECTIVO 13160105,0,117,2579.00,,280252.75,6309,
09/02/2015,09/02/2015,0,DEP.EFECTIVO 1133010679,0,2043,2721.50,,282974.25,6310,
09/02/2015,09/02/2015,0,DEP.EFECTIVO 137601015,0,1470,3921.50,,286895.75,6311,
09/02/2015,09/02/2015,0,DEP.EFECTIVO 137601017,0,1470,2816.00,,289711.75,6312,
09/02/2015,09/02/2015,0,DEP.EFECTIVO 116501073,0,1424,1745.00,,291456.75,6313,
09/02/2015,09/02/2015,0,DEP.EFECTIVO 093001065,0,691,2535.00,,293991.75,6314,
09/02/2015,09/02/2015,0,DEP.EFECTIVO 116501065,0,1424,2134.50,,296126.25,6315,
09/02/2015,09/02/2015,0,DEP.EFECTIVO 093001057,0,691,2882.50,,299008.75,6316,
09/02/2015,09/02/2015,0,DEP.EFECTIVO 126301065,0,464,3584.00,,302592.75,6317,
09/02/2015,09/02/2015,0,DEP.EFECTIVO 093001073,0,691,2695.50,,305288.25,6318,
09/02/2015,09/02/2015,0,DEPOSITO DE CUENTA DE TERCEROS,0,4253,1114.05,,306402.30,6319,"DEPOSITO EFECTIVO OFICINA TELECOMM 30035, REFERENCIA CLIENTE 0000000000"
09/02/2015,09/02/2015,0,DEP.EFECTIVO 126301057,0,464,2928.00,,309330.30,6320,
09/02/2015,09/02/2015,0,DEP.EFECTIVO 126301073,0,464,1868.00,,311198.30,6321,
09/02/2015,09/02/2015,0,DEPOSITO DE CUENTA DE TERCEROS,0,4253,1098.45,,312296.75,6322,"DEPOSITO EFECTIVO OFICINA TELECOMM 30035, REFERENCIA CLIENTE 0000000000"
09/02/2015,09/02/2015,0,DEPOSITO DE CUENTA DE TERCEROS,0,4253,1374.20,,313670.95,6323,"DEPOSITO EFECTIVO OFICINA TELECOMM 30035, REFERENCIA CLIENTE 0000000000"
09/02/2015,09/02/2015,0,DEP.EFECTIVO 099301073,0,2325,917.50,,314588.45,6324,
09/02/2015,09/02/2015,0,DEP.EFECTIVO 099301065,0,2325,1450.00,,316038.45,6325,
09/02/2015,09/02/2015,0,DEP.EFECTIVO 099301057,0,2325,1403.00,,317441.45,6326,
09/02/2015,09/02/2015,0,DEP.EFECTIVO 122701065,0,2325,1497.50,,318938.95,6327,
09/02/2015,09/02/2015,0,DEP.EFECTIVO,0,2325,925.50,,319864.45,6328,
09/02/2015,09/02/2015,0,DEP.EFECTIVO 1223701073,0,2325,630.50,,320494.95,6329,
09/02/2015,09/02/2015,0,DEP.EFECTIVO 113201050,0,2331,3792.50,,324287.45,6330,
09/02/2015,09/02/2015,0,DEP.EFECTIVO 113201068,0,2331,4153.00,,328440.45,6331,
09/02/2015,09/02/2015,0,DEP.EFECTIVO 104901072,0,2092,918.50,,329358.95,6332,
09/02/2015,09/02/2015,0,DEP.EFECTIVO 113201076,0,2331,1297.50,,330656.45,6333,
09/02/2015,09/02/2015,0,DEP.EFECTIVO 104901064,0,2092,2425.50,,333081.95,6334,
09/02/2015,09/02/2015,0,DEP.EFECTIVO 133301054,0,274,2380.00,,335461.95,6335,
09/02/2015,09/02/2015,0,DEP.EFECTIVO 133301062,0,274,1916.00,,337377.95,6336,
09/02/2015,09/02/2015,0,DEP.EFECTIVO 133301070,0,274,1402.50,,338780.45,6337,
09/02/2015,09/02/2015,0,DEP.EFECTIVO 117001068,0,274,2714.00,,341494.45,6338,
09/02/2015,09/02/2015,0,DEP.EFECTIVO 117001076,0,274,729.50,,342223.95,6339,
09/02/2015,09/02/2015,0,DEP.EFECTIVO 119613027,0,7726,1736.30,,343960.25,6340,
09/02/2015,09/02/2015,0,DEP.EFECTIVO 117001050,0,274,2527.50,,346487.75,6341,
09/02/2015,09/02/2015,0,DEP.EFECTIVO 96901056,0,2043,2683.00,,349170.75,6342,
09/02/2015,09/02/2015,0,DEP.EFECTIVO 119613035,0,7726,1372.00,,350542.75,6343,
09/02/2015,09/02/2015,0,DEP.EFECTIVO 117101058,0,1334,1550.50,,352093.25,6344,
09/02/2015,09/02/2015,0,DEP.EFECTIVO 119613043,0,7726,1215.05,,353308.30,6345,
09/02/2015,09/02/2015,0,DEP.EFECTIVO 117101066,0,1334,3559.50,,356867.80,6346,
09/02/2015,09/02/2015,0,DEP.EFECTIVO 117101074,0,1334,629.00,,357496.80,6347,
09/02/2015,09/02/2015,0,DEP.EFECTIVO 96901064,0,2043,2987.00,,360483.80,6348,
09/02/2015,09/02/2015,0,DEP.EFECTIVO 96901072,0,2043,1269.50,,361753.30,6349,
09/02/2015,09/02/2015,0,DEP.EFECTIVO 131013032,0,1508,1148.50,,362901.80,6350,
09/02/2015,09/02/2015,0,DEP.EFECTIVO 131013040,0,1508,1190.00,,364091.80,6351,
09/02/2015,09/02/2015,0,DEP.EFECTIVO 129201017,0,295,1174.50,,365266.30,6352,
09/02/2015,09/02/2015,0,DEP.EFECTIVO 129201019,0,295,1327.00,,366593.30,6353,
09/02/2015,09/02/2015,0,DEP.EFECTIVO 131013057,0,1508,1393.00,,367986.30,6354,
09/02/2015,09/02/2015,0,DEP.EFECTIVO 129201013,0,295,1223.50,,369209.80,6355,
09/02/2015,09/02/2015,0,DEP.EFECTIVO 131013065,0,1508,1178.00,,370387.80,6356,
09/02/2015,09/02/2015,0,DEP.EFECTIVO 129201015,0,295,2359.00,,372746.80,6357,
09/02/2015,09/02/2015,0,DEP.EFECTIVO 115901061,0,8013,918.50,,373665.30,6358,
09/02/2015,09/02/2015,0,DEP.EFECTIVO 115901053,0,8013,1705.50,,375370.80,6359,
09/02/2015,09/02/2015,0,DEP.EFECTIVO 110501057,0,8014,3747.50,,379118.30,6360,
09/02/2015,09/02/2015,0,DEP.EFECTIVO 110501065,0,8014,3445.50,,382563.80,6361,
09/02/2015,09/02/2015,0,DEP.EFECTIVO 1090100716,0,8113,1291.50,,383855.30,6362,
09/02/2015,09/02/2015,0,DEP.EFECTIVO 1090100653,0,8113,3666.10,,387521.40,6363,
09/02/2015,09/02/2015,0,DEP.EFECTIVO 1090100590,0,8113,4045.40,,391566.80,6364,
09/02/2015,09/02/2015,0,DEP.EFECTIVO 119101057,0,2126,1699.00,,393265.80,6365,
09/02/2015,09/02/2015,0,DEP.EFECTIVO 119101073,0,2126,1205.50,,394471.30,6366,
09/02/2015,09/02/2015,0,DEP.EFECTIVO 1419101065,0,2126,1908.00,,396379.30,6367,
09/02/2015,09/02/2015,0,DEP.EFECTIVO,0,2113,1851.00,,398230.30,6368,
09/02/2015,09/02/2015,0,DEP.EFECTIVO 107701057,0,2113,1887.00,,400117.30,6369,
09/02/2015,09/02/2015,0,DEP.EFECTIVO 107701073,0,2113,3328.50,,403445.80,6370,
09/02/2015,09/02/2015,0,DEP.EFECTIVO 150401065,0,2043,2180.50,,405626.30,6371,
09/02/2015,09/02/2015,0,DEP.EFECTIVO 124901078,0,2104,2303.50,,407929.80,6372,
09/02/2015,09/02/2015,0,DEP.EFECTIVO 124901052,0,2104,3294.00,,411223.80,6373,
09/02/2015,09/02/2015,0,DEP.EFECTIVO 124901060,0,2104,2405.50,,413629.30,6374,
09/02/2015,09/02/2015,0,DEP.EFECTIVO 150401065,0,2043,3166.50,,416795.80,6375,
09/02/2015,09/02/2015,0,DEP.EFECTIVO 150401073,0,2043,1106.00,,417901.80,6376,
09/02/2015,09/02/2015,0,DEP.EFECTIVO 95401073,0,295,1214.00,,419115.80,6377,
09/02/2015,09/02/2015,0,DEP.EFECTIVO 095401065,0,295,2523.00,,421638.80,6378,
09/02/2015,09/02/2015,0,DEP.EFECTIVO 095401049,0,295,2118.50,,423757.30,6379,
09/02/2015,09/02/2015,0,DEP.EFECTIVO 095401057,0,295,1230.50,,424987.80,6380,
09/02/2015,09/02/2015,0,DEP.EFECTIVO 104901056,0,2092,3748.00,,428735.80,6381,
09/02/2015,09/02/2015,0,DEP.EFECTIVO,0,82,909.80,,429645.60,6382,
09/02/2015,09/02/2015,0,DEP.EFECTIVO 123501051,0,2104,1020.00,,430665.60,6383,
09/02/2015,09/02/2015,0,DEP.EFECTIVO 103409069,0,82,1213.00,,431878.60,6384,
09/02/2015,09/02/2015,0,DEP.EFECTIVO 123501069,0,2104,1715.50,,433594.10,6385,
09/02/2015,09/02/2015,0,DEP.EFECTIVO 119301024,0,1508,1000.00,,434594.10,6386,
09/02/2015,09/02/2015,0,DEP.EFECTIVO 103409077,0,82,311.40,,434905.50,6387,
09/02/2015,09/02/2015,0,DEP.EFECTIVO 123501077,0,2104,1506.50,,436412.00,6388,
09/02/2015,09/02/2015,0,DEP.EFECTIVO,0,1508,1979.50,,438391.50,6389,
09/02/2015,09/02/2015,0,DEP.EFECTIVO,0,1508,1659.00,,440050.50,6390,
09/02/2015,09/02/2015,0,DEP.EFECTIVO 119301049,0,1508,1635.00,,441685.50,6391,
09/02/2015,09/02/2015,0,ANUL.DEP.EFECTIVO,501,1508,,"$1,659.00",440026.50,6392,
09/02/2015,09/02/2015,0,ANUL.DEP.EFECTIVO,501,1508,,"$1,979.50",438047.00,6393,
09/02/2015,09/02/2015,0,DEP.EFECTIVO 119301057,0,1508,1979.50,,440026.50,6394,
09/02/2015,09/02/2015,0,DEP.EFECTIVO 119301032,0,1508,1659.00,,441685.50,6395,
09/02/2015,09/02/2015,0,DEP.EFECTIVO 121801073,0,2331,990.00,,442675.50,6396,
09/02/2015,09/02/2015,0,DEP.EFECTIVO 121801057,0,2331,1719.00,,444394.50,6397,
09/02/2015,09/02/2015,0,DEP.EFECTIVO 121801065,0,2331,1035.00,,445429.50,6398,
09/02/2015,09/02/2015,0,ANUL.DEP.EFECTIVO,501,2325,,$925.50,444504.00,6399,
09/02/2015,09/02/2015,0,ANUL.DEP.EFECTIVO 12237,501,2325,,$630.50,443873.50,6400,
09/02/2015,09/02/2015,0,DEP.EFECTIVO 122701073,0,2325,630.50,,444504.00,6401,
09/02/2015,09/02/2015,0,DEP.EFECTIVO 122701057,0,2325,925.50,,445429.50,6402,
09/02/2015,09/02/2015,0,DEP.EFECTIVO 112401057,0,8701,731.00,,446160.50,6403,
09/02/2015,09/02/2015,0,DEP.EFECTIVO 112401065,0,8701,1578.50,,447739.00,6404,
09/02/2015,09/02/2015,0,DEP.EFECTIVO 112401073,0,8701,783.50,,448522.50,6405,
10/02/2015,10/02/2015,0,DEP.EFECTIVO 123601018,0,2306,807.70,,449330.20,6406,
10/02/2015,10/02/2015,200,TRASPASO A CUENTA PROPIA,790,8846,,"$447,645.19",1685.01,6407,"IVA:00000000.00 , A LA CUENTA 0136679699, 200 AL R.F.C. FTI9211036K2"
10/02/2015,10/02/2015,0,DEP.EFECTIVO 117001019,0,274,3141.50,,4826.51,6408,
10/02/2015,10/02/2015,0,DEP.EFECTIVO 102101014,0,706,2373.00,,7199.51,6409,
10/02/2015,10/02/2015,0,DEP.EFECTIVO 119101016,0,2126,2549.50,,9749.01,6410,
10/02/2015,10/02/2015,0,DEP.EFECTIVO 160201011,0,2062,7173.38,,16922.39,6411,
10/02/2015,10/02/2015,0,DEP.EFECTIVO 124301014,0,1474,2983.50,,19905.89,6412,
10/02/2015,10/02/2015,0,DEP.EFECTIVO 133301013,0,274,3272.50,,23178.39,6413,
10/02/2015,10/02/2015,0,DEP.EFECTIVO 117101017,0,1334,4643.50,,27821.89,6414,
10/02/2015,10/02/2015,0,DEP.EFECTIVO 131801014,0,2102,5175.00,,32996.89,6415,
10/02/2015,10/02/2015,0,DEP.EFECTIVO 102914010,0,8015,1391.50,,34388.39,6416,
10/02/2015,10/02/2015,0,DEP.EFECTIVO 108204010,0,188,2821.00,,37209.39,6417,
10/02/2015,10/02/2015,0,DEP.EFECTIVO 121201019,0,275,1891.00,,39100.39,6418,
10/02/2015,10/02/2015,0,DEP.EFECTIVO,0,2162,1939.50,,41039.89,6419,
10/02/2015,10/02/2015,0,DEP.EFECTIVO 122701016,0,2162,1386.00,,42425.89,6420,
10/02/2015,10/02/2015,0,ANUL.DEP.EFECTIVO,501,2162,,"$1,939.50",40486.39,6421,
10/02/2015,10/02/2015,0,DEP.EFECTIVO 099301016,0,2162,1939.50,,42425.89,6422,
10/02/2015,10/02/2015,0,DEP.EFECTIVO 113201019,0,1477,3320.00,,45745.89,6423,
10/02/2015,10/02/2015,0,DEP.EFECTIVO 100101016,0,2326,4140.00,,49885.89,6424,
10/02/2015,10/02/2015,0,DEP.EFECTIVO 137001015,0,2049,862.50,,50748.39,6425,
10/02/2015,10/02/2015,0,DEP.EFECTIVO 35102011,0,52,2773.00,,53521.39,6426,
10/02/2015,10/02/2015,0,DEP.EFECTIVO 124601074,0,2009,5054.50,,58575.89,6427,
10/02/2015,10/02/2015,0,DEP.EFECTIVO 099101017,0,1934,4439.00,,63014.89,6428,
10/02/2015,10/02/2015,0,DEP.EFECTIVO 099101016,0,1934,4337.50,,67352.39,6429,
10/02/2015,10/02/2015,0,DEP.EFECTIVO 33402017,0,52,3373.50,,70725.89,6430,
10/02/2015,10/02/2015,0,DEP.EFECTIVO 133448012,0,2460,2978.00,,73703.89,6431,
10/02/2015,10/02/2015,0,DEP.EFECTIVO 124901011,0,2162,2197.50,,75901.39,6432,
10/02/2015,10/02/2015,0,DEP.EFECTIVO 122201016,0,2069,2154.50,,78055.89,6433,
10/02/2015,10/02/2015,0,DEP.EFECTIVO 119613068,0,7726,993.80,,79049.69,6434,
10/02/2015,10/02/2015,0,DEP.EFECTIVO 119613050,0,7726,2218.10,,81267.79,6435,
10/02/2015,10/02/2015,0,DEP.EFECTIVO 098301016,0,2314,5572.00,,86839.79,6436,
10/02/2015,10/02/2015,0,DEP.EFECTIVO 118701016,0,2314,3387.00,,90226.79,6437,
10/02/2015,10/02/2015,0,DEP.EFECTIVO 111501014,0,2290,4059.50,,94286.29,6438,
10/02/2015,10/02/2015,0,DEP.EFECTIVO 1282030130,0,3190,3735.50,,98021.79,6439,
10/02/2015,10/02/2015,0,DEP.EFECTIVO 141001019,0,2009,1969.00,,99990.79,6440,
10/02/2015,10/02/2015,0,DEP.EFECTIVO 093001016,0,691,2992.00,,102982.79,6441,
10/02/2015,10/02/2015,0,DEP.EFECTIVO 094301016,0,1938,2109.00,,105091.79,6442,
10/02/2015,10/02/2015,0,DEP.EFECTIVO 104727011,0,3705,2328.00,,107419.79,6443,
10/02/2015,10/02/2015,0,DEP.EFECTIVO 102210013,0,8114,3119.00,,110538.79,6444,
10/02/2015,10/02/2015,0,DEP.EFECTIVO 34602011,0,52,1774.00,,112312.79,6445,
10/02/2015,10/02/2015,0,DEP.EFECTIVO 96824019,0,1490,3976.00,,116288.79,6446,
10/02/2015,10/02/2015,0,DEP.EFECTIVO 117513070,0,1566,2618.50,,118907.29,6447,
10/02/2015,10/02/2015,0,DEP.EFECTIVO 131013073,0,647,1223.00,,120130.29,6448,
10/02/2015,10/02/2015,0,DEP.EFECTIVO 123501010,0,2104,1463.00,,121593.29,6449,
10/02/2015,10/02/2015,0,DEP.EFECTIVO 126301016,0,464,3046.00,,124639.29,6450,
10/02/2015,10/02/2015,0,DEP.EFECTIVO 1000300154,0,2552,2962.50,,127601.79,6451,
10/02/2015,10/02/2015,0,DEP.EFECTIVO 108301016,0,3682,3293.60,,130895.39,6452,
10/02/2015,10/02/2015,0,DEP.EFECTIVO 13160101,0,117,2760.50,,133655.89,6453,
10/02/2015,10/02/2015,0,DEP.EFECTIVO 1145300172,0,2552,1697.50,,135353.39,6454,
10/02/2015,10/02/2015,0,DEP.EFECTIVO 104901015,0,2092,4581.80,,139935.19,6455,
10/02/2015,10/02/2015,0,DEP.EFECTIVO 116501016,0,1424,5036.00,,144971.19,6456,
10/02/2015,10/02/2015,0,DEP.EFECTIVO 121801016,0,2162,854.50,,145825.69,6457,
10/02/2015,10/02/2015,0,DEP.EFECTIVO 137601016,0,1470,3631.00,,149456.69,6458,
10/02/2015,10/02/2015,0,DEP.EFECTIVO 111024017,0,1490,1426.50,,150883.19,6459,
10/02/2015,10/02/2015,0,DEP.EFECTIVO 107701016,0,2162,2529.50,,153412.69,6460,
10/02/2015,10/02/2015,0,DEP.EFECTIVO 120501016,0,2382,3194.00,,156606.69,6461,
10/02/2015,10/02/2015,0,DEP.EFECTIVO 141601016,0,1938,1188.50,,157795.19,6462,
10/02/2015,10/02/2015,0,DEPOSITO DE CUENTA DE TERCEROS,0,4253,1038.35,,158833.54,6463,"DEPOSITO EFECTIVO OFICINA TELECOMM 30035, REFERENCIA CLIENTE 0000000000"
10/02/2015,10/02/2015,0,DEP.EFECTIVO 96901015,0,2043,3009.50,,161843.04,6464,
10/02/2015,10/02/2015,0,DEP.EFECTIVO 150401016,0,2043,2754.50,,164597.54,6465,
10/02/2015,10/02/2015,0,DEP.EFECTIVO 121701026,0,831,2424.50,,167022.04,6466,
10/02/2015,10/02/2015,0,DEP.EFECTIVO,0,3630,4416.50,,171438.54,6467,
10/02/2015,10/02/2015,0,DEP.EFECTIVO 1133010170,0,2043,3881.00,,175319.54,6468,
10/02/2015,10/02/2015,0,DEP.EFECTIVO 101333014,0,3682,5784.50,,181104.04,6469,
10/02/2015,10/02/2015,0,DEP.EFECTIVO 98001038,0,2162,2800.50,,183904.54,6470,
10/02/2015,10/02/2015,0,DEP.EFECTIVO 98001046,0,2162,1685.00,,185589.54,6471,
10/02/2015,10/02/2015,0,DEP.EFECTIVO 129201016,0,295,2361.00,,187950.54,6472,
10/02/2015,10/02/2015,0,DEP.EFECTIVO 98001053,0,2162,1806.00,,189756.54,6473,
10/02/2015,10/02/2015,0,DEP.EFECTIVO 91402019,0,727,2206.50,,191963.04,6474,
10/02/2015,10/02/2015,0,DEP.EFECTIVO 98001061,0,2162,2126.50,,194089.54,6475,
10/02/2015,10/02/2015,0,ANUL.DEP.EFECTIVO,501,3630,,"$4,416.50",189673.04,6476,
10/02/2015,10/02/2015,0,DEP.EFECTIVO 98001079,0,2162,1295.00,,190968.04,6477,
10/02/2015,10/02/2015,0,DEP.EFECTIVO 92508012,0,3630,4416.50,,195384.54,6478,
10/02/2015,10/02/2015,0,DEP.EFECTIVO 110501016,0,8014,4812.00,,200196.54,6479,
10/02/2015,10/02/2015,0,DEP.EFECTIVO,0,8014,2871.00,,203067.54,6480,
10/02/2015,10/02/2015,0,ANUL.DEP.EFECTIVO,501,8014,,"$2,871.00",200196.54,6481,
10/02/2015,10/02/2015,0,DEP.EFECTIVO 041201016,0,2162,3271.50,,203468.04,6482,
10/02/2015,10/02/2015,0,DEP.EFECTIVO 095401016,0,295,2132.00,,205600.04,6483,
10/02/2015,10/02/2015,0,DEP.EFECTIVO 106414017,0,8014,2871.00,,208471.04,6484,
10/02/2015,10/02/2015,0,DEP.EFECTIVO 115901012,0,8013,1334.50,,209805.54,6485,
10/02/2015,10/02/2015,0,DEP.EFECTIVO 103409010,0,7461,1024.00,,210829.54,6486,
10/02/2015,10/02/2015,0,DEP.EFECTIVO 133201015,0,12,1414.50,,212244.04,6487,
10/02/2015,10/02/2015,0,DEP.EFECTIVO 112401016,0,8717,1448.00,,213692.04,6488,
10/02/2015,10/02/2015,0,DEP.EFECTIVO 1090100144,0,8113,5579.20,,219271.24,6489,
11/02/2015,11/02/2015,0,DEP.EFECTIVO 102101022,0,706,2135.00,,221406.24,6490,
11/02/2015,11/02/2015,200,TRASPASO A CUENTA PROPIA,790,8846,,"$221,406.24",0.00,6491,"IVA:00000000.00 , A LA CUENTA 0136679699, 200 AL R.F.C. FTI9211036K2"
11/02/2015,11/02/2015,0,DEP.EFECTIVO 160201029,0,2062,1927.11,,1927.11,6492,
11/02/2015,11/02/2015,0,DEP.EFECTIVO 106414025,0,8014,2063.50,,3990.61,6493,
11/02/2015,11/02/2015,0,DEP.EFECTIVO 131801022,0,2102,3694.50,,7685.11,6494,
11/02/2015,11/02/2015,0,DEP.EFECTIVO 110501024,0,8014,3134.50,,10819.61,6495,
11/02/2015,11/02/2015,0,DEP.EFECTIVO 102914028,0,8015,1454.50,,12274.11,6496,
11/02/2015,11/02/2015,0,DEP.EFECTIVO 103409028,0,7461,954.05,,13228.16,6497,
11/02/2015,11/02/2015,0,DEP.EFECTIVO 108204028,0,188,3209.50,,16437.66,6498,
11/02/2015,11/02/2015,0,DEP.EFECTIVO 1282030290,0,3190,2681.50,,19119.16,6499,
11/02/2015,11/02/2015,0,DEP.EFECTIVO 111501022,0,2290,3790.50,,22909.66,6500,
11/02/2015,11/02/2015,0,DEP.EFECTIVO 1114130773,0,1974,2189.50,,25099.16,6501,
11/02/2015,11/02/2015,0,DEP.EFECTIVO 121201027,0,275,964.00,,26063.16,6502,
11/02/2015,11/02/2015,0,DEP.EFECTIVO 33402025,0,52,2850.50,,28913.66,6503,
11/02/2015,11/02/2015,0,DEP.EFECTIVO 124601025,0,2009,5143.00,,34056.66,6504,
11/02/2015,11/02/2015,0,DEP.EFECTIVO 117001027,0,274,1657.00,,35713.66,6505,
11/02/2015,11/02/2015,0,DEP.EFECTIVO 133448020,0,2460,1416.50,,37130.16,6506,
11/02/2015,11/02/2015,0,DEP.EFECTIVO 098301024,0,2314,3186.00,,40316.16,6507,
11/02/2015,11/02/2015,0,DEP.EFECTIVO 118701024,0,2314,2255.00,,42571.16,6508,
11/02/2015,11/02/2015,0,DEP.EFECTIVO 35102029,0,52,2933.90,,45505.06,6509,
11/02/2015,11/02/2015,0,DEP.EFECTIVO 100101024,0,2326,2721.00,,48226.06,6510,
11/02/2015,11/02/2015,0,DEP.EFECTIVO 117901010,0,2067,2621.50,,50847.56,6511,
11/02/2015,11/02/2015,0,DEP.EFECTIVO 117901028,0,2067,1960.00,,52807.56,6512,
11/02/2015,11/02/2015,0,DEP.EFECTIVO 137001023,0,2049,1692.00,,54499.56,6513,
11/02/2015,11/02/2015,0,DEP.EFECTIVO 1209130619,0,1536,1159.50,,55659.06,6514,
11/02/2015,11/02/2015,0,DEP.EFECTIVO 117101025,0,1334,4353.50,,60012.56,6515,
11/02/2015,11/02/2015,0,DEP.EFECTIVO 92508020,0,3630,5000.00,,65012.56,6516,
11/02/2015,11/02/2015,0,DEP.EFECTIVO 1209130556,0,1536,960.10,,65972.66,6517,
11/02/2015,11/02/2015,0,DEP.EFECTIVO 041201024,0,2325,2577.00,,68549.66,6518,
11/02/2015,11/02/2015,0,DEP.EFECTIVO 124301022,0,1474,2299.00,,70848.66,6519,
11/02/2015,11/02/2015,0,DEP.EFECTIVO 122201014,0,2069,2111.50,,72960.16,6520,
11/02/2015,11/02/2015,0,DEP.EFECTIVO 1114130104,0,1974,2389.50,,75349.66,6521,
11/02/2015,11/02/2015,0,DEP.EFECTIVO 96901023,0,2043,3260.00,,78609.66,6522,
11/02/2015,11/02/2015,0,DEP.EFECTIVO 91402027,0,727,2094.50,,80704.16,6523,
11/02/2015,11/02/2015,0,DEP.EFECTIVO,0,8114,3300.60,,84004.76,6524,
11/02/2015,11/02/2015,0,DEP.EFECTIVO 117513013,0,1566,2489.00,,86493.76,6525,
11/02/2015,11/02/2015,0,ANUL.DEP.EFECTIVO,501,8114,,"$3,300.60",83193.16,6526,
11/02/2015,11/02/2015,0,DEP.EFECTIVO 121701026,0,831,552.00,,83745.16,6527,
11/02/2015,11/02/2015,0,DEP.EFECTIVO 1145300235,0,2552,1745.50,,85490.66,6528,
11/02/2015,11/02/2015,0,DEP.EFECTIVO 102210021,0,8114,3300.60,,88791.26,6529,
11/02/2015,11/02/2015,0,DEP.EFECTIVO 115901020,0,8013,1263.00,,90054.26,6530,
11/02/2015,11/02/2015,0,DEP.EFECTIVO 113201027,0,2331,2719.50,,92773.76,6531,
11/02/2015,11/02/2015,0,DEP.EFECTIVO 1000300217,0,2552,2396.50,,95170.26,6532,
11/02/2015,11/02/2015,0,DEP.EFECTIVO 116501024,0,1424,2175.50,,97345.76,6533,
11/02/2015,11/02/2015,0,DEP.EFECTIVO 96824027,0,1490,3316.50,,100662.26,6534,
11/02/2015,11/02/2015,0,DEP.EFECTIVO 111024025,0,1490,1895.00,,102557.26,6535,
11/02/2015,11/02/2015,0,DEP.EFECTIVO 104727029,0,3705,1122.00,,103679.26,6536,
11/02/2015,11/02/2015,0,DEP.EFECTIVO 119101024,0,2126,1914.00,,105593.26,6537,
11/02/2015,11/02/2015,0,DEP.EFECTIVO 124901029,0,2104,3135.00,,108728.26,6538,
11/02/2015,11/02/2015,0,DEP.EFECTIVO 1090100207,0,8113,4006.00,,112734.26,6539,
11/02/2015,11/02/2015,0,DEP.EFECTIVO 141001027,0,2009,1691.00,,114425.26,6540,
11/02/2015,11/02/2015,0,DEP.EFECTIVO 108301024,0,3682,3052.00,,117477.26,6541,
11/02/2015,11/02/2015,0,DEPOSITO DE CUENTA DE TERCEROS,0,4253,830.70,,118307.96,6542,"DEPOSITO EFECTIVO OFICINA TELECOMM 30035, REFERENCIA CLIENTE 0000000000"
11/02/2015,11/02/2015,0,DEP.EFECTIVO 133201023,0,12,1547.30,,119855.26,6543,
11/02/2015,11/02/2015,0,DEP.EFECTIVO 34602029,0,143,1434.00,,121289.26,6544,
11/02/2015,11/02/2015,0,DEP.EFECTIVO 123601026,0,2306,1412.00,,122701.26,6545,
11/02/2015,11/02/2015,0,DEP.EFECTIVO 133301021,0,274,3199.00,,125900.26,6546,
11/02/2015,11/02/2015,0,DEP.EFECTIVO 123501028,0,2104,1464.00,,127364.26,6547,
11/02/2015,11/02/2015,0,DEP.EFECTIVO 122701024,0,2325,1737.00,,129101.26,6548,
11/02/2015,11/02/2015,0,DEP.EFECTIVO 094301024,0,1938,2890.00,,131991.26,6549,
11/02/2015,11/02/2015,0,DEP.EFECTIVO 101333022,0,3682,4296.05,,136287.31,6550,
11/02/2015,11/02/2015,0,DEP.EFECTIVO 1133010233,0,2043,3460.00,,139747.31,6551,
11/02/2015,11/02/2015,0,DEP.EFECTIVO 107701024,0,2113,2461.00,,142208.31,6552,
11/02/2015,11/02/2015,0,DEP.EFECTIVO 13160102,0,117,1979.00,,144187.31,6553,
11/02/2015,11/02/2015,0,DEP.EFECTIVO 137601014,0,1470,4421.50,,148608.81,6554,
11/02/2015,11/02/2015,0,DEP.EFECTIVO 120501024,0,2382,2990.50,,151599.31,6555,
11/02/2015,11/02/2015,0,DEP.EFECTIVO 150401024,0,2043,4070.50,,155669.81,6556,
11/02/2015,11/02/2015,0,DEP.EFECTIVO 129201014,0,295,1742.00,,157411.81,6557,
11/02/2015,11/02/2015,0,DEP.EFECTIVO 095401024,0,295,1548.00,,158959.81,6558,
11/02/2015,11/02/2015,0,DEP.EFECTIVO 09910104,0,1934,4665.50,,163625.31,6559,
11/02/2015,11/02/2015,0,DEP.EFECTIVO 119301065,0,1536,1481.00,,165106.31,6560,
11/02/2015,11/02/2015,0,DEP.EFECTIVO 119301073,0,1536,714.00,,165820.31,6561,
11/02/2015,11/02/2015,0,DEP.EFECTIVO 119301016,0,1536,1357.50,,167177.81,6562,
11/02/2015,11/02/2015,0,DEP.EFECTIVO,0,648,1981.00,,169158.81,6563,
11/02/2015,11/02/2015,0,ANUL.DEP.EFECTIVO,501,648,,"$1,981.00",167177.81,6564,
11/02/2015,11/02/2015,0,DEP.EFECTIVO 99213061,0,648,1981.00,,169158.81,6565,
11/02/2015,11/02/2015,0,DEP.EFECTIVO 99213079,0,648,530.50,,169689.31,6566,
11/02/2015,11/02/2015,0,DEP.EFECTIVO 99213012,0,648,3262.00,,172951.31,6567,
11/02/2015,11/02/2015,0,DEP.EFECTIVO 126301024,0,464,3335.00,,176286.31,6568,
11/02/2015,11/02/2015,0,DEP.EFECTIVO 96901023,0,2043,233.10,,176519.41,6569,
11/02/2015,11/02/2015,0,DEP.EFECTIVO 141601024,0,1938,1130.00,,177649.41,6570,
11/02/2015,11/02/2015,0,DEP.EFECTIVO 104901023,0,2092,2433.00,,180082.41,6571,
11/02/2015,11/02/2015,0,DEP.EFECTIVO 112401024,0,8717,1700.00,,181782.41,6572,
12/02/2015,12/02/2015,0,DEP.EFECTIVO 137001031,0,2049,1592.00,,183374.41,6573,
12/02/2015,12/02/2015,0,DEP.EFECTIVO 131801030,0,2102,4180.00,,187554.41,6574,
12/02/2015,12/02/2015,0,DEP.EFECTIVO 102101030,0,706,1809.50,,189363.91,6575,
12/02/2015,12/02/2015,200,TRASPASO A CUENTA PROPIA,790,8846,,"$189,363.90",0.01,6576,"IVA:00000000.00 , A LA CUENTA 0136679699, 200 AL R.F.C. FTI9211036K2"
12/02/2015,12/02/2015,0,DEP.EFECTIVO 108204036,0,188,3147.00,,3147.01,6577,
12/02/2015,12/02/2015,0,DEP.EFECTIVO 124901037,0,2104,3267.50,,6414.51,6578,
12/02/2015,12/02/2015,0,DEP.EFECTIVO 126301032,0,464,3340.00,,9754.51,6579,
12/02/2015,12/02/2015,0,DEP.EFECTIVO 35102037,0,52,2049.50,,11804.01,6580,
12/02/2015,12/02/2015,0,DEP.EFECTIVO 122201012,0,2069,1542.50,,13346.51,6581,
12/02/2015,12/02/2015,0,DEP.EFECTIVO 124601033,0,2009,3388.50,,16735.01,6582,
12/02/2015,12/02/2015,0,DEP.EFECTIVO 133448038,0,2460,1974.50,,18709.51,6583,
12/02/2015,12/02/2015,0,DEP.EFECTIVO 098301032,0,2314,4432.50,,23142.01,6584,
12/02/2015,12/02/2015,0,DEP.EFECTIVO 117001035,0,274,2717.50,,25859.51,6585,
12/02/2015,12/02/2015,0,DEP.EFECTIVO 112401032,0,8701,2418.50,,28278.01,6586,
12/02/2015,12/02/2015,0,DEP.EFECTIVO 96824035,0,1490,3801.00,,32079.01,6587,
12/02/2015,12/02/2015,0,DEP.EFECTIVO 34602037,0,143,3243.00,,35322.01,6588,
12/02/2015,12/02/2015,0,DEP.EFECTIVO 118701032,0,2314,1479.50,,36801.51,6589,
12/02/2015,12/02/2015,0,DEP.EFECTIVO 92508038,0,3630,3723.00,,40524.51,6590,
12/02/2015,12/02/2015,0,DEP.EFECTIVO 1332201031,0,2183,1760.50,,42285.01,6591,
12/02/2015,12/02/2015,0,DEP.EFECTIVO 1282030353,0,3190,1979.50,,44264.51,6592,
12/02/2015,12/02/2015,0,DEP.EFECTIVO 96901031,0,2043,2971.00,,47235.51,6593,
12/02/2015,12/02/2015,0,DEP.EFECTIVO 120501032,0,2325,1695.50,,48931.01,6594,
12/02/2015,12/02/2015,0,DEP.EFECTIVO 33402033,0,52,2176.50,,51107.51,6595,
12/02/2015,12/02/2015,0,DEP.EFECTIVO 123601034,0,2306,747.50,,51855.01,6596,
12/02/2015,12/02/2015,0,DEP.EFECTIVO 104727037,0,3705,2232.50,,54087.51,6597,
12/02/2015,12/02/2015,0,DEP.EFECTIVO 124301030,0,1474,2069.00,,56156.51,6598,
12/02/2015,12/02/2015,0,DEP.EFECTIVO 041201032,0,2325,3540.00,,59696.51,6599,
12/02/2015,12/02/2015,0,DEP.EFECTIVO 1000300377,0,2552,1993.00,,61689.51,6600,
12/02/2015,12/02/2015,0,DEP.EFECTIVO 137601012,0,1470,1796.50,,63486.01,6601,
12/02/2015,12/02/2015,0,DEP.EFECTIVO 1145300395,0,2552,1890.00,,65376.01,6602,
12/02/2015,12/02/2015,0,DEP.EFECTIVO 117513021,0,1566,1583.00,,66959.01,6603,
12/02/2015,12/02/2015,0,DEP.EFECTIVO 91402035,0,727,2228.00,,69187.01,6604,
12/02/2015,12/02/2015,0,DEP.EFECTIVO 117901036,0,2067,2257.50,,71444.51,6605,
12/02/2015,12/02/2015,0,DEP.EFECTIVO 111024033,0,1490,1463.00,,72907.51,6606,
12/02/2015,12/02/2015,0,DEP.EFECTIVO 116501032,0,1424,3263.00,,76170.51,6607,
12/02/2015,12/02/2015,0,DEP.EFECTIVO 13160103,0,117,2626.50,,78797.01,6608,
12/02/2015,12/02/2015,0,DEP.EFECTIVO 1209130779,0,1536,1313.00,,80110.01,6609,
12/02/2015,12/02/2015,0,DEPOSITO DE CUENTA DE TERCEROS,0,4253,1241.15,,81351.16,6610,"DEPOSITO EFECTIVO OFICINA TELECOMM 30035, REFERENCIA CLIENTE 0000000000"
12/02/2015,12/02/2015,0,DEP.EFECTIVO 100101032,0,2326,2622.00,,83973.16,6611,
12/02/2015,12/02/2015,0,DEP.EFECTIVO 093001024,0,691,2846.50,,86819.66,6612,
12/02/2015,12/02/2015,0,DEP.EFECTIVO 093001032,0,691,3187.00,,90006.66,6613,
12/02/2015,12/02/2015,0,DEP.EFECTIVO 099101012,0,1934,3139.00,,93145.66,6614,
12/02/2015,12/02/2015,0,DEP.EFECTIVO 121201035,0,275,2591.50,,95737.16,6615,
12/02/2015,12/02/2015,0,DEP.EFECTIVO 119613076,0,7726,1048.00,,96785.16,6616,
12/02/2015,12/02/2015,0,DEP.EFECTIVO 094301032,0,1938,1478.50,,98263.66,6617,
12/02/2015,12/02/2015,0,DEP.EFECTIVO 141601032,0,1938,1726.50,,99990.16,6618,
12/02/2015,12/02/2015,0,DEP.EFECTIVO 141001035,0,2009,1755.50,,101745.66,6619,
12/02/2015,12/02/2015,0,DEP.EFECTIVO 108301032,0,3682,5528.00,,107273.66,6620,
12/02/2015,12/02/2015,0,DEP.EFECTIVO 123501036,0,2104,1460.00,,108733.66,6621,
12/02/2015,12/02/2015,0,DEP.EFECTIVO 129201012,0,295,1413.50,,110147.16,6622,
12/02/2015,12/02/2015,0,DEP.EFECTIVO 119101032,0,2126,1571.00,,111718.16,6623,
12/02/2015,12/02/2015,0,DEP.EFECTIVO 101333030,0,3682,4925.90,,116644.06,6624,
12/02/2015,12/02/2015,0,DEP.EFECTIVO 99213020,0,648,3366.00,,120010.06,6625,
12/02/2015,12/02/2015,0,DEP.EFECTIVO 121701034,0,831,1666.00,,121676.06,6626,
12/02/2015,12/02/2015,0,DEP.EFECTIVO 095401032,0,295,2527.50,,124203.56,6627,
12/02/2015,12/02/2015,0,DEP.EFECTIVO 107701032,0,2306,2518.50,,126722.06,6628,
12/02/2015,12/02/2015,0,DEP.EFECTIVO 133301039,0,274,2953.00,,129675.06,6629,
12/02/2015,12/02/2015,0,DEP.EFECTIVO 111501030,0,2290,3626.00,,133301.06,6630,
12/02/2015,12/02/2015,0,DEP.EFECTIVO 102914036,0,8015,1644.00,,134945.06,6631,
12/02/2015,12/02/2015,0,DEP.EFECTIVO 110501032,0,8014,3045.00,,137990.06,6632,
12/02/2015,12/02/2015,0,DEP.EFECTIVO 106414033,0,8014,1709.50,,139699.56,6633,
12/02/2015,12/02/2015,0,DEP.EFECTIVO 1133010393,0,2043,3161.50,,142861.06,6634,
12/02/2015,12/02/2015,0,DEP.EFECTIVO 121801024,0,2547,770.50,,143631.56,6635,
12/02/2015,12/02/2015,0,DEP.EFECTIVO 113201035,0,1189,1587.00,,145218.56,6636,
12/02/2015,12/02/2015,0,DEP.EFECTIVO 121801032,0,2547,1176.00,,146394.56,6637,
12/02/2015,12/02/2015,0,DEP.EFECTIVO 104901031,0,2092,2205.40,,148599.96,6638,
12/02/2015,12/02/2015,0,DEP.EFECTIVO 102210039,0,8114,2617.80,,151217.76,6639,
12/02/2015,12/02/2015,0,DEP.EFECTIVO 115901038,0,8013,2219.00,,153436.76,6640,
12/02/2015,12/02/2015,0,DEP.EFECTIVO 117101033,0,1334,3658.50,,157095.26,6641,
12/02/2015,12/02/2015,0,DEP.EFECTIVO 150401032,0,2043,1911.00,,159006.26,6642,
12/02/2015,12/02/2015,0,DEP.EFECTIVO,0,7461,1204.60,,160210.86,6643,
12/02/2015,12/02/2015,0,DEP.EFECTIVO 122701032,0,2325,1440.00,,161650.86,6644,
12/02/2015,12/02/2015,0,DEP.EFECTIVO 1090100367,0,8113,2578.50,,164229.36,6645,
13/02/2015,13/02/2015,0,DEP.EFECTIVO 131801048,0,2102,5364.00,,169593.36,6646,
13/02/2015,13/02/2015,0,DEP.EFECTIVO 137001049,0,2049,423.00,,170016.36,6647,
13/02/2015,13/02/2015,200,TRASPASO A CUENTA PROPIA,790,8846,,"$169,593.35",423.01,6648,"IVA:00000000.00 , A LA CUENTA 0136679699, 200 AL R.F.C. FTI9211036K2"
13/02/2015,13/02/2015,0,DEP.EFECTIVO,0,706,1699.00,,2122.01,6649,
13/02/2015,13/02/2015,0,DEP.EFECTIVO 098301049,0,2314,3829.00,,5951.01,6650,
13/02/2015,13/02/2015,0,DEP.EFECTIVO 124301048,0,1474,3181.00,,9132.01,6651,
13/02/2015,13/02/2015,0,DEP.EFECTIVO 110501049,0,2476,3034.50,,12166.51,6652,
13/02/2015,13/02/2015,0,DEP.EFECTIVO 108204044,0,188,3881.00,,16047.51,6653,
13/02/2015,13/02/2015,0,DEP.EFECTIVO 102914044,0,8015,1109.00,,17156.51,6654,
13/02/2015,13/02/2015,0,DEP.EFECTIVO 35102045,0,52,1497.00,,18653.51,6655,
13/02/2015,13/02/2015,0,DEP.EFECTIVO 111501048,0,2290,3038.20,,21691.71,6656,
13/02/2015,13/02/2015,0,DEP.EFECTIVO 133448046,0,2460,2725.00,,24416.71,6657,
13/02/2015,13/02/2015,0,DEP.EFECTIVO 117001043,0,274,2347.00,,26763.71,6658,
13/02/2015,13/02/2015,0,DEP.EFECTIVO 33402041,0,52,1507.50,,28271.21,6659,
13/02/2015,13/02/2015,0,DEP.EFECTIVO 124601041,0,116,3389.50,,31660.71,6660,
13/02/2015,13/02/2015,0,DEP.EFECTIVO 1282030416,0,3190,1543.00,,33203.71,6661,
13/02/2015,13/02/2015,0,DEP.EFECTIVO 118701049,0,2314,3277.00,,36480.71,6662,
13/02/2015,13/02/2015,0,DEP.EFECTIVO 122201019,0,2069,2257.00,,38737.71,6663,
13/02/2015,13/02/2015,0,DEP.EFECTIVO 117901044,0,2067,3200.50,,41938.21,6664,
13/02/2015,13/02/2015,0,DEP.EFECTIVO 34602045,0,52,1239.10,,43177.31,6665,
13/02/2015,13/02/2015,0,DEP.EFECTIVO 113201043,0,2331,2914.50,,46091.81,6666,
13/02/2015,13/02/2015,0,DEP.EFECTIVO 141001043,0,2009,1296.50,,47388.31,6667,
13/02/2015,13/02/2015,0,DEP.EFECTIVO 141601049,0,1938,1197.00,,48585.31,6668,
13/02/2015,13/02/2015,0,DEP.EFECTIVO 100101040,0,2326,2556.50,,51141.81,6669,
13/02/2015,13/02/2015,0,DEP.EFECTIVO 91402043,0,727,2657.10,,53798.91,6670,
13/02/2015,13/02/2015,0,DEP.EFECTIVO 123601042,0,2306,910.00,,54708.91,6671,
13/02/2015,13/02/2015,0,DEP.EFECTIVO 104727045,0,3705,1323.00,,56031.91,6672,
13/02/2015,13/02/2015,0,DEP.EFECTIVO 1000300440,0,2552,1967.00,,57998.91,6673,
13/02/2015,13/02/2015,0,DEP.EFECTIVO 96901049,0,2043,2638.50,,60637.41,6674,
13/02/2015,13/02/2015,0,DEP.EFECTIVO 133201049,0,2183,2121.50,,62758.91,6675,
13/02/2015,13/02/2015,0,DEP.EFECTIVO 121201043,0,275,2204.50,,64963.41,6676,
13/02/2015,13/02/2015,0,DEP.EFECTIVO 120501049,0,2325,3714.00,,68677.41,6677,
13/02/2015,13/02/2015,0,DEP.EFECTIVO 96824043,0,1490,3560.00,,72237.41,6678,
13/02/2015,13/02/2015,0,DEP.EFECTIVO 041201049,0,2325,2564.00,,74801.41,6679,
13/02/2015,13/02/2015,0,DEP.EFECTIVO 094301049,0,1938,1563.00,,76364.41,6680,
13/02/2015,13/02/2015,0,DEP.EFECTIVO 13160104,0,117,2050.00,,78414.41,6681,
13/02/2015,13/02/2015,0,DEP.EFECTIVO 117101041,0,700,4625.00,,83039.41,6682,
13/02/2015,13/02/2015,0,DEP.EFECTIVO 1145300458,0,2552,1143.50,,84182.91,6683,
13/02/2015,13/02/2015,0,DEPOSITO DE CUENTA DE TERCEROS,0,4253,1182.95,,85365.86,6684,"DEPOSITO EFECTIVO OFICINA TELECOMM 30035, REFERENCIA CLIENTE 0000000000"
13/02/2015,13/02/2015,0,DEP.EFECTIVO 116501049,0,1424,4545.70,,89911.56,6685,
13/02/2015,13/02/2015,0,DEP.EFECTIVO 122701049,0,2382,1205.50,,91117.06,6686,
13/02/2015,13/02/2015,0,DEP.EFECTIVO 107701040,0,2113,1086.00,,92203.06,6687,
13/02/2015,13/02/2015,0,DEP.EFECTIVO 150401040,0,2043,2765.00,,94968.06,6688,
13/02/2015,13/02/2015,0,DEP.EFECTIVO 093001049,0,691,2939.50,,97907.56,6689,
13/02/2015,13/02/2015,0,DEP.EFECTIVO 101333048,0,3682,3798.10,,101705.66,6690,
13/02/2015,13/02/2015,0,DEP.EFECTIVO 121701042,0,831,1392.50,,103098.16,6691,
13/02/2015,13/02/2015,0,DEP.EFECTIVO 108301049,0,3682,4185.70,,107283.86,6692,
13/02/2015,13/02/2015,0,DEP.EFECTIVO 106414041,0,8014,2166.50,,109450.36,6693,
13/02/2015,13/02/2015,0,DEP.EFECTIVO 1133010456,0,2043,3198.50,,112648.86,6694,
13/02/2015,13/02/2015,0,DEP.EFECTIVO 111024041,0,2602,2332.00,,114980.86,6695,
13/02/2015,13/02/2015,0,DEP.EFECTIVO 137601019,0,1470,2098.50,,117079.36,6696,
13/02/2015,13/02/2015,0,DEP.EFECTIVO 119613019,0,7726,860.60,,117939.96,6697,
13/02/2015,13/02/2015,0,DEP.EFECTIVO 123501044,0,2104,1743.00,,119682.96,6698,
13/02/2015,13/02/2015,0,DEP.EFECTIVO 124901045,0,2104,3565.50,,123248.46,6699,
13/02/2015,13/02/2015,0,DEP.EFECTIVO 92508046,0,3630,4503.00,,127751.46,6700,
13/02/2015,13/02/2015,0,DEP.EFECTIVO 129201019,0,295,2322.00,,130073.46,6701,
13/02/2015,13/02/2015,0,DEP.EFECTIVO 115901046,0,8013,2038.50,,132111.96,6702,
13/02/2015,13/02/2015,0,DEP.EFECTIVO 119101049,0,464,1516.00,,133627.96,6703,
13/02/2015,13/02/2015,0,DEP.EFECTIVO 126301049,0,464,2335.50,,135963.46,6704,
13/02/2015,13/02/2015,0,DEP.EFECTIVO 095401049,0,295,1373.50,,137336.96,6705,
13/02/2015,13/02/2015,0,DEP.EFECTIVO 102210047,0,8114,1737.00,,139073.96,6706,
13/02/2015,13/02/2015,0,DEP.EFECTIVO,0,7450,832.50,,139906.46,6707,
13/02/2015,13/02/2015,0,ANUL.DEP.EFECTIVO,501,7450,,$832.50,139073.96,6708,
13/02/2015,13/02/2015,0,DEP.EFECTIVO 103409044,0,7450,832.50,,139906.46,6709,
13/02/2015,13/02/2015,0,DEP.EFECTIVO 104901049,0,2092,2981.50,,142887.96,6710,
13/02/2015,13/02/2015,0,DEP.EFECTIVO 121801040,0,2547,1301.00,,144188.96,6711,
13/02/2015,13/02/2015,0,DEP.EFECTIVO 133301047,0,2011,3462.00,,147650.96,6712,
13/02/2015,13/02/2015,0,DEP.EFECTIVO 099101019,0,1934,3790.00,,151440.96,6713,
13/02/2015,13/02/2015,0,DEP.EFECTIVO 1090100430,0,8117,3391.00,,154831.96,6714,
14/02/2015,16/02/2015,0,DEP.EFECTIVO,0,1536,994.00,,155825.96,6715,
14/02/2015,16/02/2015,0,DEP.EFECTIVO,0,1536,692.50,,156518.46,6716,
14/02/2015,16/02/2015,0,ANUL.DEP.EFECTIVO,501,1536,,$994.00,155524.46,6717,
14/02/2015,16/02/2015,0,DEP.EFECTIVO 1209130556,0,1536,994.00,,156518.46,6718,
14/02/2015,16/02/2015,0,ANUL.DEP.EFECTIVO,501,1536,,$692.50,155825.96,6719,
14/02/2015,16/02/2015,0,DEP.EFECTIVO 1209130493,0,1536,692.50,,156518.46,6720,
14/02/2015,16/02/2015,0,DEP.EFECTIVO,0,188,3039.00,,159557.46,6721,
14/02/2015,16/02/2015,0,ANUL.DEP.EFECTIVO,501,188,,"$3,039.00",156518.46,6722,
14/02/2015,16/02/2015,0,DEP.EFECTIVO 108204051,0,188,3039.00,,159557.46,6723,
14/02/2015,16/02/2015,0,DEP.EFECTIVO 133448053,0,2460,1650.50,,161207.96,6724,
14/02/2015,16/02/2015,0,DEP.EFECTIVO 111024058,0,1490,1557.50,,162765.46,6725,
14/02/2015,16/02/2015,0,DEP.EFECTIVO 96901056,0,2043,2808.50,,165573.96,6726,
14/02/2015,16/02/2015,0,DEP.EFECTIVO 96901049,0,2043,20.00,,165593.96,6727,
14/02/2015,16/02/2015,0,DEP.EFECTIVO 117513054,0,1566,1271.90,,166865.86,6728,
16/02/2015,16/02/2015,200,TRASPASO A CUENTA PROPIA,790,8846,,"$166,865.85",0.01,6729,"IVA:00000000.00 , A LA CUENTA 0136679699, 200 AL R.F.C. FTI9211036K2"
16/02/2015,16/02/2015,0,DEP.EFECTIVO 102101071,0,706,390.00,,390.01,6730,
16/02/2015,16/02/2015,0,DEP.EFECTIVO 102101063,0,706,1362.00,,1752.01,6731,
16/02/2015,16/02/2015,0,DEP.EFECTIVO 102101055,0,706,2484.00,,4236.01,6732,
16/02/2015,16/02/2015,0,DEP.EFECTIVO 13448061,0,2460,2924.00,,7160.01,6733,
16/02/2015,16/02/2015,0,DEP.EFECTIVO 133448079,0,2460,951.50,,8111.51,6734,
16/02/2015,16/02/2015,0,DEP.EFECTIVO 106414074,0,8014,1663.20,,9774.71,6735,
16/02/2015,16/02/2015,0,DEP.EFECTIVO 106414066,0,8014,2622.00,,12396.71,6736,
16/02/2015,16/02/2015,0,DEP.EFECTIVO 106414058,0,8014,2563.90,,14960.61,6737,
16/02/2015,16/02/2015,0,DEP.EFECTIVO 1282030576,0,3190,1592.00,,16552.61,6738,
16/02/2015,16/02/2015,0,DEP.EFECTIVO 1282030799,0,3190,254.00,,16806.61,6739,
16/02/2015,16/02/2015,0,DEP.EFECTIVO 110501065,0,8014,4330.50,,21137.11,6740,
16/02/2015,16/02/2015,0,DEP.EFECTIVO 110501057,0,8014,4991.50,,26128.61,6741,
16/02/2015,16/02/2015,0,DEP.EFECTIVO 133201072,0,2183,669.50,,26798.11,6742,
16/02/2015,16/02/2015,0,DEP.EFECTIVO 123501051,0,2104,1457.00,,28255.11,6743,
16/02/2015,16/02/2015,0,DEP.EFECTIVO 133201056,0,2183,1767.00,,30022.11,6744,
16/02/2015,16/02/2015,0,DEP.EFECTIVO 123501069,0,2104,1779.00,,31801.11,6745,
16/02/2015,16/02/2015,0,DEP.EFECTIVO 133201064,0,2183,1595.10,,33396.21,6746,
16/02/2015,16/02/2015,0,DEP.EFECTIVO 131801055,0,2102,4583.00,,37979.21,6747,
16/02/2015,16/02/2015,0,DEP.EFECTIVO 123501077,0,2104,1698.50,,39677.71,6748,
16/02/2015,16/02/2015,0,DEP.EFECTIVO 131801071,0,2102,2178.00,,41855.71,6749,
16/02/2015,16/02/2015,0,DEP.EFECTIVO 131801063,0,2102,4474.00,,46329.71,6750,
16/02/2015,16/02/2015,0,DEP.EFECTIVO 124901052,0,2104,3573.00,,49902.71,6751,
16/02/2015,16/02/2015,0,DEP.EFECTIVO 124901060,0,2104,3701.50,,53604.21,6752,
16/02/2015,16/02/2015,0,DEP.EFECTIVO 124901078,0,2104,3196.00,,56800.21,6753,
16/02/2015,16/02/2015,0,DEP.EFECTIVO,0,1508,1812.50,,58612.71,6754,
16/02/2015,16/02/2015,0,DEP.EFECTIVO 102914069,0,8015,1657.50,,60270.21,6755,
16/02/2015,16/02/2015,0,DEP.EFECTIVO 117513070,0,1508,3566.50,,63836.71,6756,
16/02/2015,16/02/2015,0,DEP.EFECTIVO,0,8015,1981.00,,65817.71,6757,
16/02/2015,16/02/2015,0,DEP.EFECTIVO 1209130619,0,1536,510.50,,66328.21,6758,
16/02/2015,16/02/2015,0,DEP.EFECTIVO 1209130779,0,1536,2237.00,,68565.21,6759,
16/02/2015,16/02/2015,0,DEP.EFECTIVO 112401057,0,8701,1324.50,,69889.71,6760,
16/02/2015,16/02/2015,0,DEP.EFECTIVO 112401073,0,8701,1448.00,,71337.71,6761,
16/02/2015,16/02/2015,0,DEP.EFECTIVO 102914077,0,8015,1818.50,,73156.21,6762,
16/02/2015,16/02/2015,0,DEP.EFECTIVO 112401065,0,8701,961.50,,74117.71,6763,
16/02/2015,16/02/2015,0,DEP.EFECTIVO 112401049,0,8701,1593.00,,75710.71,6764,
16/02/2015,16/02/2015,0,DEP.EFECTIVO 1114130773,0,1508,2380.70,,78091.41,6765,
16/02/2015,16/02/2015,0,DEP.EFECTIVO 1114130613,0,1508,2487.00,,80578.41,6766,
16/02/2015,16/02/2015,0,DEP.EFECTIVO 1114130550,0,1508,1718.00,,82296.41,6767,
16/02/2015,16/02/2015,0,DEP.EFECTIVO 1114130327,0,1508,370.40,,82666.81,6768,
16/02/2015,16/02/2015,0,DEP.EFECTIVO 1114130487,0,1508,2650.00,,85316.81,6769,
16/02/2015,16/02/2015,0,DEP.EFECTIVO 137001056,0,2049,636.50,,85953.31,6770,
16/02/2015,16/02/2015,0,DEP.EFECTIVO 137001064,0,2049,847.00,,86800.31,6771,
16/02/2015,16/02/2015,0,DEP.EFECTIVO 119613043,0,7726,69.10,,86869.41,6772,
16/02/2015,16/02/2015,0,DEP.EFECTIVO 119613050,0,7726,977.90,,87847.31,6773,
16/02/2015,16/02/2015,0,DEP.EFECTIVO 119613068,0,7726,1273.00,,89120.31,6774,
16/02/2015,16/02/2015,0,DEP.EFECTIVO 119613076,0,7726,1020.10,,90140.41,6775,
16/02/2015,16/02/2015,0,DEP.EFECTIVO 104727078,0,3705,624.00,,90764.41,6776,
16/02/2015,16/02/2015,0,DEP.EFECTIVO 104727052,0,3705,983.50,,91747.91,6777,
16/02/2015,16/02/2015,0,DEP.EFECTIVO 104727060,0,3705,2554.00,,94301.91,6778,
16/02/2015,16/02/2015,0,DEP.EFECTIVO 102914077,0,8015,171.00,,94472.91,6779,
16/02/2015,16/02/2015,0,ANUL.DEP.EFECTIVO,501,1508,,"$1,812.50",92660.41,6780,
16/02/2015,16/02/2015,0,DEP.EFECTIVO 117513062,0,1508,1812.50,,94472.91,6781,
16/02/2015,16/02/2015,0,DEP.EFECTIVO 1283130248,0,7726,1941.00,,96413.91,6782,
16/02/2015,16/02/2015,0,DEP.EFECTIVO 1283130311,0,7726,1551.00,,97964.91,6783,
16/02/2015,16/02/2015,0,DEP.EFECTIVO 1283130471,0,7726,533.00,,98497.91,6784,
16/02/2015,16/02/2015,0,DEP.EFECTIVO 1283130534,0,7726,2823.50,,101321.41,6785,
16/02/2015,16/02/2015,0,DEP.EFECTIVO 1283130694,0,7726,2875.50,,104196.91,6786,
16/02/2015,16/02/2015,0,DEP.EFECTIVO 1283130757,0,7726,1169.00,,105365.91,6787,
16/02/2015,16/02/2015,0,DEP.EFECTIVO 121701059,0,831,822.50,,106188.41,6788,
16/02/2015,16/02/2015,0,DEP.EFECTIVO 121701067,0,831,487.00,,106675.41,6789,
16/02/2015,16/02/2015,0,DEP.EFECTIVO 121701075,0,831,963.50,,107638.91,6790,
16/02/2015,16/02/2015,0,DEP.EFECTIVO 33402058,0,52,3238.50,,110877.41,6791,
16/02/2015,16/02/2015,0,DEP.EFECTIVO 33402066,0,52,3239.50,,114116.91,6792,
16/02/2015,16/02/2015,0,DEP.EFECTIVO 33402074,0,52,3238.00,,117354.91,6793,
16/02/2015,16/02/2015,0,DEP.EFECTIVO 33402066,0,52,40.00,,117394.91,6794,
16/02/2015,16/02/2015,0,DEP.EFECTIVO 117001050,0,274,2803.50,,120198.41,6795,
16/02/2015,16/02/2015,0,DEP.EFECTIVO 33402074,0,52,10.00,,120208.41,6796,
16/02/2015,16/02/2015,0,DEP.EFECTIVO 124601074,0,116,1851.00,,122059.41,6797,
16/02/2015,16/02/2015,0,DEP.EFECTIVO 117001068,0,274,3246.00,,125305.41,6798,
16/02/2015,16/02/2015,0,DEP.EFECTIVO 124301071,0,1474,2530.00,,127835.41,6799,
16/02/2015,16/02/2015,0,DEP.EFECTIVO 124601066,0,116,4122.50,,131957.91,6800,
16/02/2015,16/02/2015,0,DEP.EFECTIVO 12430063,0,1474,1844.50,,133802.41,6801,
16/02/2015,16/02/2015,0,DEP.EFECTIVO 117001076,0,274,485.50,,134287.91,6802,
16/02/2015,16/02/2015,0,DEP.EFECTIVO 124301055,0,1474,3709.00,,137996.91,6803,
16/02/2015,16/02/2015,0,DEP.EFECTIVO 124601058,0,116,3333.00,,141329.91,6804,
16/02/2015,16/02/2015,0,DEP.EFECTIVO 1090100590,0,8113,2684.50,,144014.41,6805,
16/02/2015,16/02/2015,0,DEP.EFECTIVO 1090100716,0,8113,1438.50,,145452.91,6806,
16/02/2015,16/02/2015,0,DEP.EFECTIVO 1090100653,0,8113,3767.50,,149220.41,6807,
16/02/2015,16/02/2015,0,DEP.EFECTIVO 118701073,0,2314,2666.50,,151886.91,6808,
16/02/2015,16/02/2015,0,DEP.EFECTIVO 118701065,0,2314,1919.00,,153805.91,6809,
16/02/2015,16/02/2015,0,DEP.EFECTIVO 118701057,0,2314,2363.00,,156168.91,6810,
16/02/2015,16/02/2015,0,DEP.EFECTIVO 111501071,0,2290,3854.30,,160023.21,6811,
16/02/2015,16/02/2015,0,DEP.EFECTIVO 111501063,0,2290,3242.30,,163265.51,6812,
16/02/2015,16/02/2015,0,DEP.EFECTIVO 111501055,0,2290,3479.10,,166744.61,6813,
16/02/2015,16/02/2015,0,DEP.EFECTIVO,0,8114,1934.50,,168679.11,6814,
16/02/2015,16/02/2015,0,DEP.EFECTIVO 141001050,0,2009,1090.00,,169769.11,6815,
16/02/2015,16/02/2015,0,DEP.EFECTIVO 141001076,0,2009,992.00,,170761.11,6816,
16/02/2015,16/02/2015,0,DEP.EFECTIVO 141001068,0,2009,1516.00,,172277.11,6817,
16/02/2015,16/02/2015,0,ANUL.DEP.EFECTIVO,501,8114,,"$1,934.50",170342.61,6818,
16/02/2015,16/02/2015,0,DEP.EFECTIVO 102210070,0,8114,1934.50,,172277.11,6819,
16/02/2015,16/02/2015,0,DEP.EFECTIVO 100101057,0,2326,1959.00,,174236.11,6820,
16/02/2015,16/02/2015,0,DEP.EFECTIVO 098301065,0,2314,5248.00,,179484.11,6821,
16/02/2015,16/02/2015,0,DEP.EFECTIVO 102210062,0,8114,2599.40,,182083.51,6822,
16/02/2015,16/02/2015,0,DEP.EFECTIVO 102210054,0,8114,1505.00,,183588.51,6823,
16/02/2015,16/02/2015,0,DEP.EFECTIVO 098301057,0,2314,3342.00,,186930.51,6824,
16/02/2015,16/02/2015,0,DEP.EFECTIVO 098301073,0,2314,4732.50,,191663.01,6825,
16/02/2015,16/02/2015,0,DEP.EFECTIVO 122201015,0,2069,2678.50,,194341.51,6826,
16/02/2015,16/02/2015,0,DEP.EFECTIVO 122201017,0,2069,1868.50,,196210.01,6827,
16/02/2015,16/02/2015,0,DEP.EFECTIVO 120501057,0,2325,1604.50,,197814.51,6828,
16/02/2015,16/02/2015,0,DEP.EFECTIVO 122201013,0,2069,2735.00,,200549.51,6829,
16/02/2015,16/02/2015,0,DEP.EFECTIVO 120501073,0,2325,2095.00,,202644.51,6830,
16/02/2015,16/02/2015,0,DEP.EFECTIVO 120501065,0,2325,3262.00,,205906.51,6831,
16/02/2015,16/02/2015,0,DEP.EFECTIVO 041201065,0,2325,4657.00,,210563.51,6832,
16/02/2015,16/02/2015,0,DEP.EFECTIVO 041201057,0,2325,2665.50,,213229.01,6833,
16/02/2015,16/02/2015,0,DEP.EFECTIVO 041201073,0,2325,2903.50,,216132.51,6834,
16/02/2015,16/02/2015,0,DEP.EFECTIVO 1000300726,0,2552,1618.50,,217751.01,6835,
16/02/2015,16/02/2015,0,DEP.EFECTIVO 1000300503,0,2552,1736.50,,219487.51,6836,
16/02/2015,16/02/2015,0,DEP.EFECTIVO 1000300663,0,2552,1840.00,,221327.51,6837,
16/02/2015,16/02/2015,0,DEP.EFECTIVO 111024066,0,1490,2562.50,,223890.01,6838,
16/02/2015,16/02/2015,0,DEP.EFECTIVO 111024074,0,1490,1223.00,,225113.01,6839,
16/02/2015,16/02/2015,0,DEP.EFECTIVO 117901051,0,2067,1775.50,,226888.51,6840,
16/02/2015,16/02/2015,0,DEP.EFECTIVO 117901069,0,2067,2012.00,,228900.51,6841,
16/02/2015,16/02/2015,0,DEP.EFECTIVO 137601017,0,1470,2731.00,,231631.51,6842,
16/02/2015,16/02/2015,0,DEP.EFECTIVO 117901077,0,2067,1614.00,,233245.51,6843,
16/02/2015,16/02/2015,0,DEP.EFECTIVO 137601013,0,1470,2261.50,,235507.01,6844,
16/02/2015,16/02/2015,0,DEP.EFECTIVO 137601015,0,1470,6800.00,,242307.01,6845,
16/02/2015,17/02/2015,0,CHQ.LOCAL 016319 35102078,6,52,390.64,,242697.65,6846,BCO :0044 CTA. 0014504659449 NO.CHEQUE 0000016319
16/02/2015,16/02/2015,0,DEP.EFECTIVO 96824050,0,1490,4171.00,,246868.65,6847,
16/02/2015,16/02/2015,0,DEP.EFECTIVO 35102078,0,52,1259.36,,248128.01,6848,
16/02/2015,16/02/2015,0,DEP.EFECTIVO 96824068,0,1490,2614.50,,250742.51,6849,
16/02/2015,16/02/2015,0,DEP.EFECTIVO 96824076,0,1490,1355.50,,252098.01,6850,
16/02/2015,16/02/2015,0,DEP.EFECTIVO 35102052,0,52,2358.50,,254456.51,6851,
16/02/2015,16/02/2015,0,DEP.EFECTIVO 35102060,0,52,1933.00,,256389.51,6852,
16/02/2015,16/02/2015,0,DEP.EFECTIVO 34602060,0,52,1516.50,,257906.01,6853,
16/02/2015,16/02/2015,0,DEP.EFECTIVO 34602078,0,52,1100.50,,259006.51,6854,
16/02/2015,16/02/2015,0,DEP.EFECTIVO 34602052,0,52,1621.00,,260627.51,6855,
16/02/2015,16/02/2015,0,DEP.EFECTIVO 108301057,0,3682,2770.80,,263398.31,6856,
16/02/2015,16/02/2015,0,DEP.EFECTIVO 108301065,0,3682,2067.00,,265465.31,6857,
16/02/2015,16/02/2015,0,DEP.EFECTIVO 108301073,0,3682,1428.10,,266893.41,6858,
16/02/2015,16/02/2015,0,DEP.EFECTIVO 150401073,0,2043,1240.50,,268133.91,6859,
16/02/2015,16/02/2015,0,DEP.EFECTIVO 92508079,0,3630,3355.00,,271488.91,6860,
16/02/2015,16/02/2015,0,DEP.EFECTIVO 150401065,0,2043,2630.00,,274118.91,6861,
16/02/2015,16/02/2015,0,DEP.EFECTIVO 150401057,0,2043,3184.00,,277302.91,6862,
16/02/2015,16/02/2015,0,DEP.EFECTIVO 1133010679,0,2043,1953.00,,279255.91,6863,
16/02/2015,16/02/2015,0,DEP.EFECTIVO 92508061,0,3630,4422.00,,283677.91,6864,
16/02/2015,16/02/2015,0,DEP.EFECTIVO 121201068,0,275,1370.50,,285048.41,6865,
16/02/2015,16/02/2015,0,DEP.EFECTIVO 1133010742,0,2043,3547.00,,288595.41,6866,
16/02/2015,16/02/2015,0,DEP.EFECTIVO 121201050,0,275,2027.00,,290622.41,6867,
16/02/2015,16/02/2015,0,DEP.EFECTIVO 92508053,0,3630,4266.50,,294888.91,6868,
16/02/2015,16/02/2015,0,DEP.EFECTIVO 121201076,0,275,773.50,,295662.41,6869,
16/02/2015,16/02/2015,0,DEP.EFECTIVO 103409051,0,7450,1758.75,,297421.16,6870,
16/02/2015,16/02/2015,0,DEP.EFECTIVO 1133010519,0,2043,2084.00,,299505.16,6871,
16/02/2015,16/02/2015,0,DEP.EFECTIVO 103409077,0,7450,925.20,,300430.36,6872,
16/02/2015,16/02/2015,0,DEP.EFECTIVO 119101065,0,2126,1177.00,,301607.36,6873,
16/02/2015,16/02/2015,0,DEP.EFECTIVO,0,7450,1782.00,,303389.36,6874,
16/02/2015,16/02/2015,0,DEP.EFECTIVO 119101073,0,2126,2626.00,,306015.36,6875,
16/02/2015,16/02/2015,0,DEP.EFECTIVO 094301073,0,1938,1376.50,,307391.86,6876,
16/02/2015,16/02/2015,0,DEP.EFECTIVO 119101057,0,2126,1127.00,,308518.86,6877,
16/02/2015,16/02/2015,0,DEP.EFECTIVO 094301057,0,1938,2207.70,,310726.56,6878,
16/02/2015,16/02/2015,0,DEP.EFECTIVO 094301065,0,1938,1347.50,,312074.06,6879,
16/02/2015,16/02/2015,0,DEP.EFECTIVO 116501065,0,1424,2407.00,,314481.06,6880,
16/02/2015,16/02/2015,0,DEP.EFECTIVO 96901072,0,2043,1453.00,,315934.06,6881,
16/02/2015,16/02/2015,0,DEP.EFECTIVO 116501057,0,1424,1988.70,,317922.76,6882,
16/02/2015,16/02/2015,0,DEP.EFECTIVO 96901064,0,2043,2989.00,,320911.76,6883,
16/02/2015,16/02/2015,0,DEP.EFECTIVO 116501073,0,1424,1575.00,,322486.76,6884,
16/02/2015,16/02/2015,0,DEP.EFECTIVO 92508079,0,3630,0.50,,322487.26,6885,
16/02/2015,16/02/2015,0,DEP.EFECTIVO 1145300681,0,2552,1823.00,,324310.26,6886,
16/02/2015,16/02/2015,0,DEP.EFECTIVO 1145300744,0,2552,1487.50,,325797.76,6887,
16/02/2015,16/02/2015,0,DEP.EFECTIVO 1145300521,0,2552,1410.50,,327208.26,6888,
16/02/2015,16/02/2015,0,DEP.EFECTIVO 093001057,0,691,3555.00,,330763.26,6889,
16/02/2015,16/02/2015,0,DEP.EFECTIVO 093001065,0,691,3128.00,,333891.26,6890,
16/02/2015,16/02/2015,0,DEP.EFECTIVO 093001073,0,691,2614.00,,336505.26,6891,
16/02/2015,16/02/2015,0,DEP.EFECTIVO 123601075,0,2306,1086.50,,337591.76,6892,
16/02/2015,16/02/2015,0,DEP.EFECTIVO 123601059,0,2306,1312.60,,338904.36,6893,
16/02/2015,16/02/2015,0,DEP.EFECTIVO 123601067,0,2306,1103.50,,340007.86,6894,
16/02/2015,16/02/2015,0,DEP.EFECTIVO 99213038,0,648,1578.00,,341585.86,6895,
16/02/2015,16/02/2015,0,DEP.EFECTIVO 99213046,0,648,116.50,,341702.36,6896,
16/02/2015,16/02/2015,0,DEP.EFECTIVO 101333063,0,3682,4749.80,,346452.16,6897,
16/02/2015,16/02/2015,0,DEP.EFECTIVO 131013040,0,1508,1017.50,,347469.66,6898,
16/02/2015,16/02/2015,0,DEP.EFECTIVO 101333055,0,3682,3273.10,,350742.76,6899,
16/02/2015,16/02/2015,0,DEP.EFECTIVO 99213053,0,648,2695.50,,353438.26,6900,
16/02/2015,16/02/2015,0,DEP.EFECTIVO 131013024,0,1508,612.50,,354050.76,6901,
16/02/2015,16/02/2015,0,DEP.EFECTIVO 99213061,0,648,3136.20,,357186.96,6902,
16/02/2015,16/02/2015,0,DEP.EFECTIVO 131013032,0,1508,902.50,,358089.46,6903,
16/02/2015,16/02/2015,0,DEP.EFECTIVO 131013057,0,1508,1078.70,,359168.16,6904,
16/02/2015,16/02/2015,0,DEP.EFECTIVO 131013073,0,1508,1146.00,,360314.16,6905,
16/02/2015,16/02/2015,0,DEP.EFECTIVO 131013065,0,1508,1512.00,,361826.16,6906,
16/02/2015,16/02/2015,0,DEP.EFECTIVO 126301057,0,464,2581.50,,364407.66,6907,
16/02/2015,16/02/2015,0,DEP.EFECTIVO 126301065,0,464,2279.50,,366687.16,6908,
16/02/2015,16/02/2015,0,DEP.EFECTIVO 101333071,0,3682,2781.50,,369468.66,6909,
16/02/2015,16/02/2015,0,DEP.EFECTIVO 126301073,0,464,2605.50,,372074.16,6910,
16/02/2015,16/02/2015,0,DEP.EFECTIVO 13160106,0,117,3159.00,,375233.16,6911,
16/02/2015,16/02/2015,0,DEP.EFECTIVO 119301073,0,1508,893.50,,376126.66,6912,
16/02/2015,16/02/2015,0,DEP.EFECTIVO 113201068,0,1189,3335.00,,379461.66,6913,
16/02/2015,16/02/2015,0,DEP.EFECTIVO,0,1508,835.40,,380297.06,6914,
16/02/2015,16/02/2015,0,DEP.EFECTIVO 13160107,0,117,2474.00,,382771.06,6915,
16/02/2015,16/02/2015,0,DEP.EFECTIVO 119301024,0,1508,951.00,,383722.06,6916,
16/02/2015,16/02/2015,0,DEP.EFECTIVO 13160105,0,117,2299.50,,386021.56,6917,
16/02/2015,16/02/2015,0,DEP.EFECTIVO 113201050,0,1189,2733.00,,388754.56,6918,
16/02/2015,16/02/2015,0,DEP.EFECTIVO 113201076,0,1189,2486.50,,391241.06,6919,
16/02/2015,16/02/2015,0,ANUL.DEP.EFECTIVO,501,1508,,$835.40,390405.66,6920,
16/02/2015,16/02/2015,0,DEP.EFECTIVO 107701057,0,2270,2323.00,,392728.66,6921,
16/02/2015,16/02/2015,0,DEP.EFECTIVO 119301049,0,1508,835.40,,393564.06,6922,
16/02/2015,16/02/2015,0,DEP.EFECTIVO 107701065,0,2270,2314.00,,395878.06,6923,
16/02/2015,16/02/2015,0,DEP.EFECTIVO 107701073,0,2270,2400.50,,398278.56,6924,
16/02/2015,16/02/2015,0,DEP.EFECTIVO 119301057,0,1508,1402.50,,399681.06,6925,
16/02/2015,16/02/2015,0,DEP.EFECTIVO 119301065,0,1508,2347.50,,402028.56,6926,
16/02/2015,16/02/2015,0,DEPOSITO DE CUENTA DE TERCEROS,0,4253,1467.80,,403496.36,6927,"DEPOSITO EFECTIVO OFICINA TELECOMM 30035, REFERENCIA CLIENTE 0000000000"
16/02/2015,16/02/2015,0,DEP.EFECTIVO 108204077,0,188,1043.50,,404539.86,6928,
16/02/2015,16/02/2015,0,DEP.EFECTIVO 117101058,0,1334,3868.50,,408408.36,6929,
16/02/2015,16/02/2015,0,DEP.EFECTIVO 108204069,0,188,2614.00,,411022.36,6930,
16/02/2015,16/02/2015,0,DEP.EFECTIVO 117101066,0,1334,2165.00,,413187.36,6931,
16/02/2015,16/02/2015,0,DEPOSITO DE CUENTA DE TERCEROS,0,4253,1226.00,,414413.36,6932,"DEPOSITO EFECTIVO OFICINA TELECOMM 30035, REFERENCIA CLIENTE 0000000000"
16/02/2015,16/02/2015,0,DEP.EFECTIVO 117101074,0,1334,984.70,,415398.06,6933,
16/02/2015,16/02/2015,0,DEP.EFECTIVO 141601065,0,1938,1276.50,,416674.56,6934,
16/02/2015,16/02/2015,0,DEPOSITO DE CUENTA DE TERCEROS,0,4253,1668.40,,418342.96,6935,"DEPOSITO EFECTIVO OFICINA TELECOMM 30035, REFERENCIA CLIENTE 0000000000"
16/02/2015,16/02/2015,0,DEP.EFECTIVO,0,1938,1087.00,,419429.96,6936,
16/02/2015,16/02/2015,0,DEP.EFECTIVO 141601073,0,1938,839.00,,420268.96,6937,
16/02/2015,16/02/2015,0,DEP.EFECTIVO 129201017,0,295,1841.50,,422110.46,6938,
16/02/2015,16/02/2015,0,DEP.EFECTIVO 129201015,0,295,1721.00,,423831.46,6939,
16/02/2015,16/02/2015,0,DEP.EFECTIVO 129201013,0,295,1915.50,,425746.96,6940,
16/02/2015,16/02/2015,0,DEP.EFECTIVO 104901064,0,463,3273.50,,429020.46,6941,
16/02/2015,16/02/2015,0,DEP.EFECTIVO 115901053,0,8013,2684.50,,431704.96,6942,
16/02/2015,16/02/2015,0,DEP.EFECTIVO 104901072,0,463,732.00,,432436.96,6943,
16/02/2015,16/02/2015,0,DEP.EFECTIVO 115901061,0,8013,1399.00,,433835.96,6944,
16/02/2015,16/02/2015,0,DEP.EFECTIVO 104901056,0,463,1876.00,,435711.96,6945,
16/02/2015,16/02/2015,0,DEP.EFECTIVO 133301054,0,3,2519.00,,438230.96,6946,
16/02/2015,16/02/2015,0,DEP.EFECTIVO 133301070,0,3,1003.50,,439234.46,6947,
16/02/2015,16/02/2015,0,DEP.EFECTIVO 133301062,0,3,3844.00,,443078.46,6948,
16/02/2015,16/02/2015,200,TRASPASO A CUENTA PROPIA,790,8846,,"$442,687.81",390.65,6949,"IVA:00000000.00 , A LA CUENTA 0136679699, 200 AL R.F.C. FTI9211036K2"
16/02/2015,16/02/2015,0,DEP.EFECTIVO 122701057,0,2382,1253.00,,1643.65,6950,
16/02/2015,16/02/2015,0,DEP.EFECTIVO 122701065,0,2382,1862.50,,3506.15,6951,
16/02/2015,16/02/2015,0,DEP.EFECTIVO 122701073,0,2382,921.50,,4427.65,6952,
16/02/2015,16/02/2015,0,DEP.EFECTIVO 99213079,0,648,1189.50,,5617.15,6953,
16/02/2015,16/02/2015,0,DEP.EFECTIVO 095401057,0,295,1747.00,,7364.15,6954,
16/02/2015,16/02/2015,0,DEP.EFECTIVO 095401065,0,295,2771.90,,10136.05,6955,
16/02/2015,16/02/2015,0,DEP.EFECTIVO 095401073,0,295,2597.40,,12733.45,6956,
16/02/2015,16/02/2015,0,DEP.EFECTIVO 121801057,0,2433,1587.50,,14320.95,6957,
16/02/2015,16/02/2015,0,DEP.EFECTIVO 121801065,0,2433,1352.50,,15673.45,6958,
16/02/2015,16/02/2015,0,DEP.EFECTIVO 121801073,0,2433,599.00,,16272.45,6959,
16/02/2015,16/02/2015,0,DEP.EFECTIVO 099101017,0,1934,2865.00,,19137.45,6960,
16/02/2015,16/02/2015,0,DEP.EFECTIVO 099101015,0,1934,4478.00,,23615.45,6961,
17/02/2015,17/02/2015,0,DEP.EFECTIVO 123501010,0,2104,902.00,,24517.45,6962,
17/02/2015,17/02/2015,0,DEP.EFECTIVO 124901011,0,2104,3933.50,,28450.95,6963,
17/02/2015,17/02/2015,0,DEP.EFECTIVO 102101014,0,706,1806.00,,30256.95,6964,
17/02/2015,17/02/2015,0,DEP.EFECTIVO 116501016,0,1424,3312.83,,33569.78,6965,
17/02/2015,17/02/2015,0,DEP.EFECTIVO 107701016,0,2306,4016.00,,37585.78,6966,
17/02/2015,17/02/2015,0,DEP.EFECTIVO 094031016,0,1938,3369.00,,40954.78,6967,
17/02/2015,17/02/2015,0,DEP.EFECTIVO 118701016,0,2314,1923.50,,42878.28,6968,
17/02/2015,17/02/2015,0,DEP.EFECTIVO 098301016,0,2314,3992.00,,46870.28,6969,
17/02/2015,17/02/2015,200,TRASPASO A CUENTA PROPIA,790,8846,,"$37,195.13",9675.15,6970,"IVA:00000000.00 , A LA CUENTA 0136679699, TRASPASO 200 AL R.F.C. FTI9211036K2"
17/02/2015,17/02/2015,0,ANUL.DEP.EFECTIVO 09403,501,1938,,"$3,369.00",6306.15,6971,
17/02/2015,17/02/2015,0,DEP.EFECTIVO 094301016,0,1938,3369.00,,9675.15,6972,
17/02/2015,17/02/2015,0,DEP.EFECTIVO 108204010,0,188,1469.57,,11144.72,6973,
17/02/2015,17/02/2015,0,DEP.EFECTIVO 117001019,0,3,3454.50,,14599.22,6974,
17/02/2015,17/02/2015,0,ANUL.DEP.EFECTIVO 09430,501,1938,,"$3,369.00",11230.22,6975,
17/02/2015,17/02/2015,0,DEP.EFECTIVO 094301016,0,1938,3080.00,,14310.22,6976,
17/02/2015,17/02/2015,0,DEP.EFECTIVO 133301013,0,3,2494.50,,16804.72,6977,
17/02/2015,17/02/2015,0,DEP.EFECTIVO 131801014,0,2102,5623.50,,22428.22,6978,
17/02/2015,17/02/2015,0,DEP.EFECTIVO 041201016,0,2162,3837.00,,26265.22,6979,
17/02/2015,17/02/2015,0,DEP.EFECTIVO 98001012,0,2096,1396.00,,27661.22,6980,
17/02/2015,17/02/2015,0,DEP.EFECTIVO 98001020,0,2096,2680.50,,30341.72,6981,
17/02/2015,17/02/2015,0,DEP.EFECTIVO 98001079,0,2096,1991.50,,32333.22,6982,
17/02/2015,17/02/2015,0,DEP.EFECTIVO 98001061,0,2096,3162.00,,35495.22,6983,
17/02/2015,17/02/2015,0,DEP.EFECTIVO 98001053,0,2096,2052.50,,37547.72,6984,
17/02/2015,17/02/2015,0,DEP.EFECTIVO 98001046,0,2096,1348.50,,38896.22,6985,
17/02/2015,17/02/2015,0,DEP.EFECTIVO 98001038,0,2096,1425.50,,40321.72,6986,
17/02/2015,17/02/2015,0,DEP.EFECTIVO 124601074,0,2009,2919.00,,43240.72,6987,
17/02/2015,17/02/2015,0,DEP.EFECTIVO 106414017,0,8014,3821.30,,47062.02,6988,
17/02/2015,17/02/2015,0,DEP.EFECTIVO 137601016,0,1470,3142.20,,50204.22,6989,
17/02/2015,17/02/2015,0,DEP.EFECTIVO 1133010170,0,2043,3753.50,,53957.72,6990,
17/02/2015,17/02/2015,0,DEP.EFECTIVO 126301016,0,464,3473.50,,57431.22,6991,
17/02/2015,17/02/2015,0,DEP.EFECTIVO 123601018,0,2306,1501.50,,58932.72,6992,
17/02/2015,17/02/2015,0,DEP.EFECTIVO 119101016,0,2126,2712.00,,61644.72,6993,
17/02/2015,17/02/2015,0,DEP.EFECTIVO 122701016,0,2162,1521.50,,63166.22,6994,
17/02/2015,17/02/2015,0,DEP.EFECTIVO 093001016,0,691,1430.50,,64596.72,6995,
17/02/2015,17/02/2015,0,DEP.EFECTIVO 1282030130,0,3190,2018.00,,66614.72,6996,
17/02/2015,17/02/2015,0,DEP.EFECTIVO 117101017,0,2162,3640.00,,70254.72,6997,
17/02/2015,17/02/2015,0,DEP.EFECTIVO 121201019,0,275,2473.10,,72727.82,6998,
17/02/2015,17/02/2015,0,DEP.EFECTIVO 111024017,0,1490,2066.00,,74793.82,6999,
17/02/2015,17/02/2015,0,DEP.EFECTIVO 137001015,0,2162,1482.00,,76275.82,7000,
17/02/2015,17/02/2015,0,DEP.EFECTIVO 133448012,0,2460,3397.50,,79673.32,7001,
17/02/2015,17/02/2015,0,DEP.EFECTIVO 124301014,0,1474,4369.00,,84042.32,7002,
17/02/2015,17/02/2015,0,DEP.EFECTIVO 141001019,0,2009,876.50,,84918.82,7003,
17/02/2015,17/02/2015,0,DEP.EFECTIVO 35102011,0,52,1115.54,,86034.36,7004,
17/02/2015,17/02/2015,0,DEP.EFECTIVO 115901012,0,8013,2829.30,,88863.66,7005,
17/02/2015,17/02/2015,0,DEP.EFECTIVO 99213012,0,1508,3135.11,,91998.77,7006,
17/02/2015,17/02/2015,0,DEP.EFECTIVO 133201015,0,2183,2184.50,,94183.27,7007,
17/02/2015,17/02/2015,0,DEP.EFECTIVO 33402017,0,52,2840.40,,97023.67,7008,
17/02/2015,17/02/2015,0,DEP.EFECTIVO 1209130110,0,1536,627.73,,97651.40,7009,
17/02/2015,17/02/2015,0,DEP.EFECTIVO 104727011,0,3705,1938.50,,99589.90,7010,
17/02/2015,17/02/2015,0,DEP.EFECTIVO 121701018,0,831,1716.06,,101305.96,7011,
17/02/2015,17/02/2015,0,DEP.EFECTIVO 122201016,0,2069,3131.00,,104436.96,7012,
17/02/2015,17/02/2015,0,DEP.EFECTIVO 104901015,0,2092,2743.85,,107180.81,7013,
17/02/2015,17/02/2015,0,DEP.EFECTIVO 117901010,0,2067,2293.50,,109474.31,7014,
17/02/2015,17/02/2015,0,DEP.EFECTIVO 1000300154,0,2552,2395.17,,111869.48,7015,
17/02/2015,17/02/2015,0,DEP.EFECTIVO 141601016,0,2162,1539.50,,113408.98,7016,
17/02/2015,17/02/2015,0,DEP.EFECTIVO 120501016,0,2382,3332.23,,116741.21,7017,
17/02/2015,17/02/2015,0,DEP.EFECTIVO 92508012,0,3630,5209.20,,121950.41,7018,
17/02/2015,17/02/2015,0,DEP.EFECTIVO 150401016,0,2043,3782.00,,125732.41,7019,
17/02/2015,17/02/2015,0,DEP.EFECTIVO 1145300172,0,2552,2387.17,,128119.58,7020,
17/02/2015,17/02/2015,0,DEP.EFECTIVO 121801016,0,2162,1560.00,,129679.58,7021,
17/02/2015,17/02/2015,0,DEP.EFECTIVO 095401016,0,295,2347.50,,132027.08,7022,
17/02/2015,17/02/2015,0,DEP.EFECTIVO 110501016,0,8014,4317.50,,136344.58,7023,
17/02/2015,17/02/2015,0,DEP.EFECTIVO 96901015,0,2043,3610.50,,139955.08,7024,
17/02/2015,17/02/2015,0,DEPOSITO DE CUENTA DE TERCEROS,0,4253,518.80,,140473.88,7025,"DEPOSITO EFECTIVO OFICINA TELECOMM 30035, REFERENCIA CLIENTE 0000000000"
17/02/2015,17/02/2015,0,DEP.EFECTIVO 96824019,0,2605,3812.23,,144286.11,7026,
17/02/2015,17/02/2015,0,DEP.EFECTIVO 129201016,0,295,2633.00,,146919.11,7027,
17/02/2015,17/02/2015,0,DEP.EFECTIVO 113201019,0,2162,4067.10,,150986.21,7028,
17/02/2015,17/02/2015,0,DEP.EFECTIVO 34602011,0,52,632.10,,151618.31,7029,
17/02/2015,17/02/2015,0,DEP.EFECTIVO 101333014,0,3682,4657.75,,156276.06,7030,
17/02/2015,17/02/2015,0,DEP.EFECTIVO 13160101,0,2162,2517.50,,158793.56,7031,
17/02/2015,17/02/2015,0,DEP.EFECTIVO 111501014,0,2290,4503.30,,163296.86,7032,
17/02/2015,17/02/2015,0,DEP.EFECTIVO 119613019,0,7726,1956.15,,165253.01,7033,
17/02/2015,17/02/2015,0,DEP.EFECTIVO 117513013,0,1566,836.89,,166089.90,7034,
17/02/2015,17/02/2015,0,DEP.EFECTIVO 103409010,0,7450,503.73,,166593.63,7035,
17/02/2015,17/02/2015,0,DEP.EFECTIVO 108301016,0,3682,4632.87,,171226.50,7036,
17/02/2015,17/02/2015,0,DEP.EFECTIVO 102914010,0,8015,1418.00,,172644.50,7037,
17/02/2015,17/02/2015,0,DEP.EFECTIVO 131013016,0,166,1159.30,,173803.80,7038,
17/02/2015,17/02/2015,0,DEP.EFECTIVO 119301016,0,1536,646.08,,174449.88,7039,
17/02/2015,17/02/2015,0,DEP.EFECTIVO 099101016,0,1934,3952.00,,178401.88,7040,
17/02/2015,17/02/2015,0,DEP.EFECTIVO 102210013,0,8114,3794.01,,182195.89,7041,
17/02/2015,17/02/2015,0,DEP.EFECTIVO 1090100144,0,8113,5069.70,,187265.59,7042,
17/02/2015,17/02/2015,0,DEP.EFECTIVO 8112401016,0,8717,1525.00,,188790.59,7043,
18/02/2015,18/02/2015,0,DEP.EFECTIVO 102101022,0,706,1175.00,,189965.59,7044,
18/02/2015,18/02/2015,200,TRASPASO A CUENTA PROPIA,790,8846,,"$189,965.58",0.01,7045,"IVA:00000000.00 , A LA CUENTA 0136679699, 200 AL R.F.C. FTI9211036K2"
18/02/2015,18/02/2015,0,DEP.EFECTIVO 110501024,0,8014,4627.50,,4627.51,7046,
18/02/2015,18/02/2015,0,DEP.EFECTIVO 111024025,0,1490,2127.00,,6754.51,7047,
18/02/2015,18/02/2015,0,DEP.EFECTIVO 108504028,0,188,2860.00,,9614.51,7048,
18/02/2015,18/02/2015,0,DEP.EFECTIVO 1209130270,0,1536,1487.50,,11102.01,7049,
18/02/2015,18/02/2015,0,DEP.EFECTIVO 126301024,0,464,3303.00,,14405.01,7050,
18/02/2015,18/02/2015,0,DEP.EFECTIVO 106414025,0,8014,2107.50,,16512.51,7051,
18/02/2015,18/02/2015,0,DEP.EFECTIVO 041201024,0,2325,4923.50,,21436.01,7052,
18/02/2015,18/02/2015,0,ANUL.DEP.EFECTIVO 10850,501,188,,"$2,860.00",18576.01,7053,
18/02/2015,18/02/2015,0,DEP.EFECTIVO 108204028,0,188,2860.00,,21436.01,7054,
18/02/2015,18/02/2015,0,DEP.EFECTIVO 133201023,0,2183,2238.50,,23674.51,7055,
18/02/2015,18/02/2015,0,DEP.EFECTIVO,0,1334,3859.50,,27534.01,7056,
18/02/2015,18/02/2015,0,DEP.EFECTIVO 124601025,0,116,4730.50,,32264.51,7057,
18/02/2015,18/02/2015,0,DEP.EFECTIVO 121701026,0,831,779.50,,33044.01,7058,
18/02/2015,18/02/2015,0,DEP.EFECTIVO 34602029,0,52,3201.50,,36245.51,7059,
18/02/2015,18/02/2015,0,DEP.EFECTIVO 1090100207,0,8113,5212.50,,41458.01,7060,
18/02/2015,18/02/2015,0,DEP.EFECTIVO 116501024,0,1424,4855.50,,46313.51,7061,
18/02/2015,18/02/2015,0,DEP.EFECTIVO 141001035,0,116,1234.00,,47547.51,7062,
18/02/2015,18/02/2015,0,DEP.EFECTIVO 133448020,0,2460,4219.00,,51766.51,7063,
18/02/2015,18/02/2015,0,DEP.EFECTIVO 098301024,0,2314,4529.00,,56295.51,7064,
18/02/2015,18/02/2015,0,DEP.EFECTIVO 118701024,0,2314,2826.50,,59122.01,7065,
18/02/2015,18/02/2015,0,DEP.EFECTIVO 33402025,0,52,1920.00,,61042.01,7066,
18/02/2015,18/02/2015,0,DEP.EFECTIVO 1282030290,0,3190,1427.00,,62469.01,7067,
18/02/2015,18/02/2015,0,DEP.EFECTIVO 102210021,0,8114,3386.50,,65855.51,7068,
18/02/2015,18/02/2015,0,DEP.EFECTIVO 35102029,0,52,1794.00,,67649.51,7069,
18/02/2015,18/02/2015,0,DEP.EFECTIVO 96824027,0,1490,2666.00,,70315.51,7070,
18/02/2015,18/02/2015,0,DEP.EFECTIVO 119101024,0,2126,2451.00,,72766.51,7071,
18/02/2015,18/02/2015,0,DEP.EFECTIVO 104901023,0,2092,2710.50,,75477.01,7072,
18/02/2015,18/02/2015,0,DEP.EFECTIVO 99213020,0,648,4053.50,,79530.51,7073,
18/02/2015,18/02/2015,0,DEP.EFECTIVO 120501024,0,2325,3894.50,,83425.01,7074,
18/02/2015,18/02/2015,0,DEP.EFECTIVO 131801022,0,2102,6056.00,,89481.01,7075,
18/02/2015,18/02/2015,0,DEP.EFECTIVO 117513021,0,1566,1807.00,,91288.01,7076,
18/02/2015,18/02/2015,0,DEP.EFECTIVO 124301022,0,1474,3609.00,,94897.01,7077,
18/02/2015,18/02/2015,0,DEP.EFECTIVO 122201014,0,2069,3322.00,,98219.01,7078,
18/02/2015,18/02/2015,0,DEP.EFECTIVO 96901023,0,2043,2946.00,,101165.01,7079,
18/02/2015,18/02/2015,0,DEP.EFECTIVO 121201027,0,275,1217.00,,102382.01,7080,
18/02/2015,18/02/2015,0,DEP.EFECTIVO 124901029,0,2104,2474.00,,104856.01,7081,
18/02/2015,18/02/2015,0,DEP.EFECTIVO 117901028,0,2067,1504.50,,106360.51,7082,
18/02/2015,18/02/2015,0,DEP.EFECTIVO 117001027,0,274,2100.00,,108460.51,7083,
18/02/2015,18/02/2015,0,DEP.EFECTIVO 123601026,0,2306,1130.50,,109591.01,7084,
18/02/2015,18/02/2015,0,DEP.EFECTIVO 094301024,0,1938,2161.50,,111752.51,7085,
18/02/2015,18/02/2015,0,DEP.EFECTIVO 13160102,0,117,2820.00,,114572.51,7086,
18/02/2015,18/02/2015,0,DEP.EFECTIVO 129201014,0,295,1597.50,,116170.01,7087,
18/02/2015,18/02/2015,0,DEP.EFECTIVO 1000300217,0,2552,1962.00,,118132.01,7088,
18/02/2015,18/02/2015,0,DEP.EFECTIVO 1145300235,0,2552,1759.50,,119891.51,7089,
18/02/2015,18/02/2015,0,DEP.EFECTIVO 119301024,0,1536,1739.00,,121630.51,7090,
18/02/2015,18/02/2015,0,DEP.EFECTIVO 141601024,0,1938,1422.00,,123052.51,7091,
18/02/2015,18/02/2015,0,DEPOSITO DE CUENTA DE TERCEROS,0,4253,1830.80,,124883.31,7092,"DEPOSITO EFECTIVO OFICINA TELECOMM 30035, REFERENCIA CLIENTE 0000000000"
18/02/2015,18/02/2015,0,DEP.EFECTIVO 119613027,0,7726,219.42,,125102.73,7093,
18/02/2015,18/02/2015,0,DEP.EFECTIVO 104727029,0,3705,1943.00,,127045.73,7094,
18/02/2015,18/02/2015,0,DEP.EFECTIVO 107701024,0,2113,3035.50,,130081.23,7095,
18/02/2015,18/02/2015,0,DEP.EFECTIVO 1133010233,0,2043,4278.00,,134359.23,7096,
18/02/2015,18/02/2015,0,DEP.EFECTIVO 91402019,0,727,714.00,,135073.23,7097,
18/02/2015,18/02/2015,0,DEP.EFECTIVO 91402027,0,727,1188.30,,136261.53,7098,
18/02/2015,18/02/2015,0,DEP.EFECTIVO 91402050,0,727,2045.20,,138306.73,7099,
18/02/2015,18/02/2015,0,DEP.EFECTIVO 91402068,0,727,1222.50,,139529.23,7100,
18/02/2015,18/02/2015,0,DEP.EFECTIVO 91402076,0,727,1399.50,,140928.73,7101,
18/02/2015,18/02/2015,0,DEP.EFECTIVO 1114130104,0,1974,604.82,,141533.55,7102,
18/02/2015,18/02/2015,0,DEP.EFECTIVO 1114130264,0,1974,1683.50,,143217.05,7103,
18/02/2015,18/02/2015,0,DEP.EFECTIVO 093001024,0,691,3565.50,,146782.55,7104,
18/02/2015,18/02/2015,0,DEP.EFECTIVO 122701024,0,2325,1070.50,,147853.05,7105,
18/02/2015,18/02/2015,0,DEP.EFECTIVO 133301021,0,3,2097.00,,149950.05,7106,
18/02/2015,18/02/2015,0,DEP.EFECTIVO 101333022,0,3682,4067.10,,154017.15,7107,
18/02/2015,18/02/2015,0,DEP.EFECTIVO 123501028,0,2104,1796.00,,155813.15,7108,
18/02/2015,18/02/2015,0,DEP.EFECTIVO 102914028,0,8015,1645.50,,157458.65,7109,
18/02/2015,18/02/2015,0,DEP.EFECTIVO,0,2331,3661.50,,161120.15,7110,
18/02/2015,18/02/2015,0,DEP.EFECTIVO 108301024,0,3682,4425.50,,165545.65,7111,
18/02/2015,18/02/2015,0,DEP.EFECTIVO 095401024,0,295,1728.00,,167273.65,7112,
18/02/2015,18/02/2015,0,DEP.EFECTIVO 115901020,0,8013,1917.00,,169190.65,7113,
18/02/2015,18/02/2015,0,DEP.EFECTIVO 137001023,0,2346,1254.50,,170445.15,7114,
18/02/2015,18/02/2015,0,DEP.EFECTIVO 111501022,0,699,3787.00,,174232.15,7115,
18/02/2015,18/02/2015,0,DEP.EFECTIVO 150401024,0,2043,3014.00,,177246.15,7116,
18/02/2015,18/02/2015,0,DEP.EFECTIVO 137601014,0,1470,4414.20,,181660.35,7117,
18/02/2015,18/02/2015,0,DEP.EFECTIVO 099101014,0,12,4869.00,,186529.35,7118,
18/02/2015,18/02/2015,0,DEP.EFECTIVO 92508020,0,3630,4636.75,,191166.10,7119,
18/02/2015,18/02/2015,0,DEP.EFECTIVO 121801024,0,2547,1150.50,,192316.60,7120,
18/02/2015,18/02/2015,0,DEP.EFECTIVO 103409028,0,82,2203.00,,194519.60,7121,
18/02/2015,18/02/2015,0,DEP.EFECTIVO 112401024,0,8717,1614.00,,196133.60,7122,
19/02/2015,19/02/2015,0,DEP.EFECTIVO 102101030,0,706,1417.50,,197551.10,7123,
19/02/2015,19/02/2015,200,TRASPASO A CUENTA PROPIA,790,8846,,"$197,551.09",0.01,7124,"IVA:00000000.00 , A LA CUENTA 0136679699, 200 AL R.F.C. FTI9211036K2"
19/02/2015,19/02/2015,0,DEP.EFECTIVO 131801030,0,2102,4839.50,,4839.51,7125,
19/02/2015,19/02/2015,0,DEP.EFECTIVO 094301032,0,1938,2907.00,,7746.51,7126,
19/02/2015,19/02/2015,0,DEP.EFECTIVO 106414033,0,8014,2547.00,,10293.51,7127,
19/02/2015,19/02/2015,0,DEP.EFECTIVO 133448038,0,2460,2601.00,,12894.51,7128,
19/02/2015,19/02/2015,0,DEP.EFECTIVO 1209130333,0,1536,768.00,,13662.51,7129,
19/02/2015,19/02/2015,0,DEP.EFECTIVO 124601033,0,116,3459.00,,17121.51,7130,
19/02/2015,19/02/2015,0,DEP.EFECTIVO 112401032,0,8701,1176.00,,18297.51,7131,
19/02/2015,19/02/2015,0,DEP.EFECTIVO 117001035,0,274,2813.50,,21111.01,7132,
19/02/2015,19/02/2015,0,DEP.EFECTIVO 098301032,0,2314,2320.00,,23431.01,7133,
19/02/2015,19/02/2015,0,DEP.EFECTIVO 118701032,0,2314,2603.50,,26034.51,7134,
19/02/2015,19/02/2015,0,DEP.EFECTIVO 122201012,0,2069,2361.50,,28396.01,7135,
19/02/2015,19/02/2015,0,DEP.EFECTIVO 34602037,0,143,2087.00,,30483.01,7136,
19/02/2015,19/02/2015,0,DEP.EFECTIVO 108204036,0,188,2816.70,,33299.71,7137,
19/02/2015,19/02/2015,0,DEP.EFECTIVO 1282030353,0,3190,1112.00,,34411.71,7138,
19/02/2015,19/02/2015,0,DEP.EFECTIVO 104727037,0,3705,2330.50,,36742.21,7139,
19/02/2015,19/02/2015,0,DEP.EFECTIVO 98001012,0,1477,2579.00,,39321.21,7140,
19/02/2015,19/02/2015,0,DEP.EFECTIVO 1332201031,0,2183,2251.00,,41572.21,7141,
19/02/2015,19/02/2015,0,DEP.EFECTIVO 121201035,0,275,1932.50,,43504.71,7142,
19/02/2015,19/02/2015,0,DEP.EFECTIVO 98001020,0,1477,2053.50,,45558.21,7143,
19/02/2015,19/02/2015,0,DEP.EFECTIVO 96824035,0,1490,4189.00,,49747.21,7144,
19/02/2015,19/02/2015,0,DEP.EFECTIVO 111501030,0,2290,4909.00,,54656.21,7145,
19/02/2015,19/02/2015,0,DEP.EFECTIVO 35102037,0,52,2475.10,,57131.31,7146,
19/02/2015,19/02/2015,0,DEP.EFECTIVO 111024033,0,1490,1318.50,,58449.81,7147,
19/02/2015,19/02/2015,0,DEP.EFECTIVO 123601034,0,2306,1438.50,,59888.31,7148,
19/02/2015,19/02/2015,0,DEP.EFECTIVO 33402033,0,52,2085.50,,61973.81,7149,
19/02/2015,19/02/2015,0,DEP.EFECTIVO 1145300395,0,2552,1350.50,,63324.31,7150,
19/02/2015,19/02/2015,0,DEP.EFECTIVO 131013024,0,166,1285.50,,64609.81,7151,
19/02/2015,19/02/2015,0,DEP.EFECTIVO 131013032,0,166,1493.50,,66103.31,7152,
19/02/2015,19/02/2015,0,DEP.EFECTIVO 1000300377,0,2552,1687.50,,67790.81,7153,
19/02/2015,19/02/2015,0,DEP.EFECTIVO 117101033,0,1334,3078.00,,70868.81,7154,
19/02/2015,19/02/2015,0,DEP.EFECTIVO 041201032,0,2325,5482.50,,76351.31,7155,
19/02/2015,19/02/2015,0,DEP.EFECTIVO 117901036,0,2067,2070.50,,78421.81,7156,
19/02/2015,19/02/2015,0,DEP.EFECTIVO 92508038,0,3630,5722.50,,84144.31,7157,
19/02/2015,19/02/2015,0,DEP.EFECTIVO 120501032,0,2325,3494.50,,87638.81,7158,
19/02/2015,19/02/2015,0,DEP.EFECTIVO 99213038,0,648,2266.50,,89905.31,7159,
19/02/2015,19/02/2015,0,DEP.EFECTIVO 110501032,0,8014,4332.50,,94237.81,7160,
19/02/2015,19/02/2015,0,DEP.EFECTIVO 13160103,0,117,2815.50,,97053.31,7161,
19/02/2015,19/02/2015,0,DEP.EFECTIVO 116501032,0,1424,3709.00,,100762.31,7162,
19/02/2015,19/02/2015,0,DEP.EFECTIVO 141001035,0,2009,2052.50,,102814.81,7163,
19/02/2015,19/02/2015,0,DEP.EFECTIVO 124901037,0,2104,3461.00,,106275.81,7164,
19/02/2015,19/02/2015,0,DEP.EFECTIVO 124301030,0,1474,2614.00,,108889.81,7165,
19/02/2015,19/02/2015,0,DEP.EFECTIVO 119613035,0,7726,836.40,,109726.21,7166,
19/02/2015,19/02/2015,0,DEP.EFECTIVO 969021031,0,2043,2908.50,,112634.71,7167,
19/02/2015,19/02/2015,0,DEP.EFECTIVO 1114130327,0,1974,1492.00,,114126.71,7168,
19/02/2015,19/02/2015,0,DEP.EFECTIVO 91402035,0,727,1564.50,,115691.21,7169,
19/02/2015,19/02/2015,0,DEP.EFECTIVO 101333030,0,3682,2197.50,,117888.71,7170,
19/02/2015,19/02/2015,0,DEPOSITO DE CUENTA DE TERCEROS,0,4253,1992.10,,119880.81,7171,"DEPOSITO EFECTIVO OFICINA TELECOMM 30035, REFERENCIA CLIENTE 0000000000"
19/02/2015,19/02/2015,0,DEP.EFECTIVO 113201035,0,2331,2050.00,,121930.81,7172,
19/02/2015,19/02/2015,0,DEP.EFECTIVO 1133010393,0,2043,2784.50,,124715.31,7173,
19/02/2015,19/02/2015,0,DEP.EFECTIVO 121701034,0,831,563.50,,125278.81,7174,
19/02/2015,19/02/2015,0,DEP.EFECTIVO 150401032,0,2043,2353.50,,127632.31,7175,
19/02/2015,19/02/2015,0,DEP.EFECTIVO 119101032,0,2126,1953.00,,129585.31,7176,
19/02/2015,19/02/2015,0,DEP.EFECTIVO 1090100367,0,8113,5042.50,,134627.81,7177,
19/02/2015,19/02/2015,0,DEP.EFECTIVO 095401032,0,295,1670.00,,136297.81,7178,
19/02/2015,19/02/2015,0,DEP.EFECTIVO 129201012,0,295,2857.00,,139154.81,7179,
19/02/2015,19/02/2015,0,DEP.EFECTIVO 119301032,0,1536,989.00,,140143.81,7180,
19/02/2015,19/02/2015,0,DEP.EFECTIVO 108301032,0,3682,2499.10,,142642.91,7181,
19/02/2015,19/02/2015,0,DEP.EFECTIVO 133301039,0,3,2247.00,,144889.91,7182,
19/02/2015,19/02/2015,0,DEP.EFECTIVO 126301032,0,464,3699.50,,148589.41,7183,
19/02/2015,19/02/2015,0,DEP.EFECTIVO 107701032,0,2306,2366.50,,150955.91,7184,
19/02/2015,19/02/2015,0,DEP.EFECTIVO 137001031,0,2049,1566.00,,152521.91,7185,
19/02/2015,19/02/2015,0,DEP.EFECTIVO 123501036,0,2104,2251.00,,154772.91,7186,
19/02/2015,19/02/2015,0,DEP.EFECTIVO 121801032,0,2331,1257.50,,156030.41,7187,
19/02/2015,19/02/2015,0,DEP.EFECTIVO 122701032,0,2325,1423.50,,157453.91,7188,
19/02/2015,19/02/2015,0,DEP.EFECTIVO 102210039,0,8114,2475.00,,159928.91,7189,
19/02/2015,19/02/2015,0,DEP.EFECTIVO 115901038,0,8013,2023.00,,161951.91,7190,
19/02/2015,19/02/2015,0,DEP.EFECTIVO 099101012,0,1934,3845.50,,165797.41,7191,
19/02/2015,19/02/2015,0,DEP.EFECTIVO 103409036,0,7461,1763.00,,167560.41,7192,
19/02/2015,19/02/2015,0,DEP.EFECTIVO 117513039,0,1566,1984.00,,169544.41,7193,
19/02/2015,19/02/2015,0,DEP.EFECTIVO 137601012,0,1470,3975.50,,173519.91,7194,
19/02/2015,19/02/2015,0,DEP.EFECTIVO 141601032,0,1938,1546.51,,175066.42,7195,
19/02/2015,19/02/2015,0,DEP.EFECTIVO 104901031,0,2092,2334.50,,177400.92,7196,
19/02/2015,19/02/2015,0,DEP.EFECTIVO 102914044,0,8015,1890.00,,179290.92,7197,
20/02/2015,20/02/2015,0,DEP.EFECTIVO 102101048,0,706,2718.90,,182009.82,7198,
20/02/2015,20/02/2015,0,DEP.EFECTIVO 122701049,0,2162,1279.50,,183289.32,7199,
20/02/2015,20/02/2015,200,TRASPASO A CUENTA PROPIA,790,8846,,"$182,009.81",1279.51,7200,"IVA:00000000.00 , A LA CUENTA 0136679699, 200 AL R.F.C. FTI9211036K2"
20/02/2015,20/02/2015,0,DEP.EFECTIVO 108204044,0,188,2250.10,,3529.61,7201,
20/02/2015,20/02/2015,0,DEP.EFECTIVO 137001049,0,2049,1038.00,,4567.61,7202,
20/02/2015,20/02/2015,0,DEP.EFECTIVO 131801048,0,2102,5883.50,,10451.11,7203,
20/02/2015,20/02/2015,0,DEP.EFECTIVO 123501044,0,2104,1692.50,,12143.61,7204,
20/02/2015,20/02/2015,0,DEP.EFECTIVO 094301049,0,1938,2006.00,,14149.61,7205,
20/02/2015,20/02/2015,0,DEP.EFECTIVO 33402041,0,52,3015.50,,17165.11,7206,
20/02/2015,20/02/2015,0,DEP.EFECTIVO 117001043,0,274,2378.50,,19543.61,7207,
20/02/2015,20/02/2015,0,DEP.EFECTIVO 122201019,0,2069,2150.50,,21694.11,7208,
20/02/2015,20/02/2015,0,DEP.EFECTIVO 133448046,0,2460,3933.50,,25627.61,7209,
20/02/2015,20/02/2015,0,DEP.EFECTIVO 35102045,0,52,1128.00,,26755.61,7210,
20/02/2015,20/02/2015,0,DEP.EFECTIVO 141001043,0,2009,1633.50,,28389.11,7211,
20/02/2015,20/02/2015,0,DEP.EFECTIVO 124601041,0,2009,2799.50,,31188.61,7212,
20/02/2015,20/02/2015,0,DEP.EFECTIVO 121701042,0,831,886.50,,32075.11,7213,
20/02/2015,20/02/2015,0,DEP.EFECTIVO 118701049,0,2314,2225.00,,34300.11,7214,
20/02/2015,20/02/2015,0,DEP.EFECTIVO 098301049,0,2314,3863.50,,38163.61,7215,
20/02/2015,20/02/2015,0,DEP.EFECTIVO 150401040,0,2043,3145.50,,41309.11,7216,
20/02/2015,20/02/2015,0,DEP.EFECTIVO 041201049,0,2325,4369.50,,45678.61,7217,
20/02/2015,20/02/2015,0,DEP.EFECTIVO 34602045,0,53,1998.00,,47676.61,7218,
20/02/2015,20/02/2015,0,DEP.EFECTIVO 120501049,0,2325,3812.50,,51489.11,7219,
20/02/2015,20/02/2015,0,DEP.EFECTIVO 117901044,0,2067,1871.70,,53360.81,7220,
20/02/2015,20/02/2015,0,DEP.EFECTIVO 111024041,0,1490,1862.00,,55222.81,7221,
20/02/2015,20/02/2015,0,DEP.EFECTIVO 1282030416,0,3190,2232.00,,57454.81,7222,
20/02/2015,20/02/2015,0,DEP.EFECTIVO 111501048,0,2290,3755.50,,61210.31,7223,
20/02/2015,20/02/2015,0,DEP.EFECTIVO 124301048,0,1474,2683.50,,63893.81,7224,
20/02/2015,20/02/2015,0,DEP.EFECTIVO 110501049,0,8011,3566.00,,67459.81,7225,
20/02/2015,20/02/2015,0,DEP.EFECTIVO 104727045,0,3705,2507.50,,69967.31,7226,
20/02/2015,20/02/2015,0,DEP.EFECTIVO 96824043,0,1490,3102.00,,73069.31,7227,
20/02/2015,20/02/2015,0,DEP.EFECTIVO 1000300440,0,2552,2479.50,,75548.81,7228,
20/02/2015,20/02/2015,0,DEP.EFECTIVO 119101049,0,2126,2461.50,,78010.31,7229,
20/02/2015,20/02/2015,0,DEP.EFECTIVO 123601042,0,2306,769.00,,78779.31,7230,
20/02/2015,20/02/2015,0,DEP.EFECTIVO 13160104,0,117,2894.00,,81673.31,7231,
20/02/2015,20/02/2015,0,DEP.EFECTIVO 99213046,0,648,2753.00,,84426.31,7232,
20/02/2015,20/02/2015,0,DEP.EFECTIVO 1145300458,0,2552,1188.50,,85614.81,7233,
20/02/2015,20/02/2015,0,DEP.EFECTIVO 92508046,0,3630,6209.50,,91824.31,7234,
20/02/2015,20/02/2015,0,DEP.EFECTIVO 96901049,0,2043,3114.00,,94938.31,7235,
20/02/2015,20/02/2015,0,DEP.EFECTIVO 141601049,0,1938,1356.00,,96294.31,7236,
20/02/2015,20/02/2015,0,DEP.EFECTIVO 116501049,0,1424,2827.70,,99122.01,7237,
20/02/2015,20/02/2015,0,DEP.EFECTIVO 124901045,0,2104,3882.50,,103004.51,7238,
20/02/2015,20/02/2015,0,DEP.EFECTIVO 117513047,0,1566,1975.00,,104979.51,7239,
20/02/2015,20/02/2015,0,DEP.EFECTIVO 095401049,0,295,2213.00,,107192.51,7240,
20/02/2015,20/02/2015,0,DEP.EFECTIVO 129201019,0,295,2018.50,,109211.01,7241,
20/02/2015,20/02/2015,0,DEP.EFECTIVO 133201049,0,2183,1314.00,,110525.01,7242,
20/02/2015,20/02/2015,0,DEP.EFECTIVO 131013040,0,647,1657.50,,112182.51,7243,
20/02/2015,20/02/2015,0,DEP.EFECTIVO 126301049,0,464,1936.50,,114119.01,7244,
20/02/2015,20/02/2015,0,DEP.EFECTIVO 121201043,0,275,1674.00,,115793.01,7245,
20/02/2015,20/02/2015,0,DEP.EFECTIVO 107701040,0,2113,2531.50,,118324.51,7246,
20/02/2015,20/02/2015,0,DEP.EFECTIVO 101333048,0,3682,5169.80,,123494.31,7247,
20/02/2015,20/02/2015,0,DEP.EFECTIVO 1114130487,0,1974,2155.00,,125649.31,7248,
20/02/2015,20/02/2015,0,DEP.EFECTIVO 137601019,0,1470,2950.50,,128599.81,7249,
20/02/2015,20/02/2015,0,DEP.EFECTIVO 1133010456,0,2043,2933.50,,131533.31,7250,
20/02/2015,20/02/2015,0,DEP.EFECTIVO 101333022,0,3682,5.00,,131538.31,7251,
20/02/2015,20/02/2015,0,DEP.EFECTIVO 119613043,0,7726,1096.00,,132634.31,7252,
20/02/2015,20/02/2015,0,DEP.EFECTIVO 119301049,0,1536,1646.00,,134280.31,7253,
20/02/2015,20/02/2015,0,DEP.EFECTIVO 91402043,0,727,1975.90,,136256.21,7254,
20/02/2015,20/02/2015,0,DEP.EFECTIVO 108301049,0,3682,2136.00,,138392.21,7255,
20/02/2015,20/02/2015,0,DEP.EFECTIVO 093001049,0,691,3203.00,,141595.21,7256,
20/02/2015,20/02/2015,0,DEP.EFECTIVO 133301047,0,3,2455.00,,144050.21,7257,
20/02/2015,20/02/2015,0,DEP.EFECTIVO 102210047,0,8114,2575.00,,146625.21,7258,
20/02/2015,20/02/2015,0,DEP.EFECTIVO 106414041,0,8014,2385.00,,149010.21,7259,
20/02/2015,20/02/2015,0,DEP.EFECTIVO 103409044,0,7450,2143.05,,151153.26,7260,
20/02/2015,20/02/2015,0,DEP.EFECTIVO 099101019,0,1934,4387.00,,155540.26,7261,
20/02/2015,20/02/2015,0,DEP.EFECTIVO 117101041,0,1334,3285.50,,158825.76,7262,
20/02/2015,20/02/2015,0,DEP.EFECTIVO 102914044,0,8015,1775.50,,160601.26,7263,
20/02/2015,20/02/2015,0,DEP.EFECTIVO 113201043,0,2331,3266.00,,163867.26,7264,
20/02/2015,20/02/2015,0,DEP.EFECTIVO 104901049,0,2092,3189.50,,167056.76,7265,
20/02/2015,20/02/2015,0,DEP.EFECTIVO 1090100430,0,8117,4578.50,,171635.26,7266,
20/02/2015,20/02/2015,0,DEP.EFECTIVO 112401049,0,8717,1543.50,,173178.76,7267,
21/02/2015,23/02/2015,0,DEP.EFECTIVO 96901056,0,2043,2926.50,,176105.26,7268,
21/02/2015,23/02/2015,0,DEP.EFECTIVO 111024058,0,1490,962.50,,177067.76,7269,
21/02/2015,23/02/2015,0,DEP.EFECTIVO 108204051,0,188,4117.70,,181185.46,7270,
21/02/2015,23/02/2015,0,DEP.EFECTIVO 1209130556,0,1536,650.00,,181835.46,7271,
21/02/2015,23/02/2015,0,DEP.EFECTIVO 1209130493,0,1536,1856.00,,183691.46,7272,
21/02/2015,23/02/2015,0,DEP.EFECTIVO 133448053,0,2460,3587.00,,187278.46,7273,
21/02/2015,23/02/2015,0,DEP.EFECTIVO 117513054,0,1566,1758.50,,189036.96,7274,
23/02/2015,23/02/2015,0,DEP.EFECTIVO 041201057,0,2325,3237.00,,192273.96,7275,
23/02/2015,23/02/2015,0,DEP.EFECTIVO 041201065,0,2325,5851.50,,198125.46,7276,
23/02/2015,23/02/2015,0,DEP.EFECTIVO 041201073,0,2325,1709.50,,199834.96,7277,
23/02/2015,23/02/2015,0,DEP.EFECTIVO 102101055,0,1581,2967.10,,202802.06,7278,
23/02/2015,23/02/2015,0,DEP.EFECTIVO 102101063,0,1581,2695.20,,205497.26,7279,
23/02/2015,23/02/2015,0,DEP.EFECTIVO 102101071,0,1581,1037.00,,206534.26,7280,
23/02/2015,23/02/2015,0,DEP.EFECTIVO 123501077,0,2474,1760.50,,208294.76,7281,
23/02/2015,23/02/2015,0,DEP.EFECTIVO 123501051,0,2474,1891.00,,210185.76,7282,
23/02/2015,23/02/2015,0,DEP.EFECTIVO 123501069,0,2474,1656.50,,211842.26,7283,
23/02/2015,23/02/2015,200,TRASPASO A CUENTA PROPIA,790,8846,,"$211,842.25",0.01,7284,"IVA:00000000.00 , A LA CUENTA 0136679699, 200 AL R.F.C. FTI9211036K2"
23/02/2015,23/02/2015,0,DEP.EFECTIVO 124901078,0,2104,1724.00,,1724.01,7285,
23/02/2015,23/02/2015,0,DEP.EFECTIVO 124901060,0,2104,4333.50,,6057.51,7286,
23/02/2015,23/02/2015,0,DEP.EFECTIVO 124901052,0,2104,3753.00,,9810.51,7287,
23/02/2015,23/02/2015,0,DEP.EFECTIVO 110501065,0,8014,2609.50,,12420.01,7288,
23/02/2015,23/02/2015,0,DEP.EFECTIVO 110501057,0,8014,2808.50,,15228.51,7289,
23/02/2015,23/02/2015,0,DEP.EFECTIVO 094301057,0,1938,2555.00,,17783.51,7290,
23/02/2015,23/02/2015,0,DEP.EFECTIVO 094301073,0,1938,2024.50,,19808.01,7291,
23/02/2015,23/02/2015,0,DEP.EFECTIVO 094301065,0,1938,2043.50,,21851.51,7292,
23/02/2015,23/02/2015,0,DEP.EFECTIVO 117513070,0,1508,3106.00,,24957.51,7293,
23/02/2015,23/02/2015,0,DEP.EFECTIVO,0,1508,2164.00,,27121.51,7294,
23/02/2015,23/02/2015,0,ANUL.DEP.EFECTIVO,501,1508,,"$2,164.00",24957.51,7295,
23/02/2015,23/02/2015,0,DEP.EFECTIVO 117513062,0,1508,2164.00,,27121.51,7296,
23/02/2015,23/02/2015,0,DEP.EFECTIVO,0,1536,753.90,,27875.41,7297,
23/02/2015,23/02/2015,0,ANUL.DEP.EFECTIVO,501,1536,,$753.90,27121.51,7298,
23/02/2015,23/02/2015,0,DEP.EFECTIVO 1209130779,0,1536,753.90,,27875.41,7299,
23/02/2015,23/02/2015,0,DEP.EFECTIVO 1209130619,0,1536,2350.00,,30225.41,7300,
23/02/2015,23/02/2015,0,DEP.EFECTIVO 102210054,0,8114,3321.00,,33546.41,7301,
23/02/2015,23/02/2015,0,DEP.EFECTIVO 102210062,0,8114,3285.00,,36831.41,7302,
23/02/2015,23/02/2015,0,DEP.EFECTIVO 102210070,0,8114,1426.80,,38258.21,7303,
23/02/2015,23/02/2015,0,DEP.EFECTIVO 131801071,0,2102,1779.00,,40037.21,7304,
23/02/2015,23/02/2015,0,DEP.EFECTIVO 131801055,0,2102,5723.00,,45760.21,7305,
23/02/2015,23/02/2015,0,DEP.EFECTIVO,0,188,3763.00,,49523.21,7306,
23/02/2015,23/02/2015,0,DEP.EFECTIVO 108204077,0,188,1497.50,,51020.71,7307,
23/02/2015,23/02/2015,0,ANUL.DEP.EFECTIVO,501,188,,"$3,763.00",47257.71,7308,
23/02/2015,23/02/2015,0,DEP.EFECTIVO 108204069,0,188,3763.00,,51020.71,7309,
23/02/2015,23/02/2015,0,DEP.EFECTIVO 1114130613,0,1974,1843.50,,52864.21,7310,
23/02/2015,23/02/2015,0,DEP.EFECTIVO 1114130550,0,1974,2511.50,,55375.71,7311,
23/02/2015,23/02/2015,0,DEP.EFECTIVO 1114130773,0,1974,2580.50,,57956.21,7312,
23/02/2015,23/02/2015,0,DEP.EFECTIVO 117901051,0,2067,1293.50,,59249.71,7313,
23/02/2015,23/02/2015,0,DEP.EFECTIVO 117901069,0,2067,2476.50,,61726.21,7314,
23/02/2015,23/02/2015,0,DEP.EFECTIVO 117901077,0,2067,1462.50,,63188.71,7315,
23/02/2015,23/02/2015,0,DEP.EFECTIVO 119613068,0,7726,1099.90,,64288.61,7316,
23/02/2015,23/02/2015,0,DEP.EFECTIVO 119613050,0,7726,1134.85,,65423.46,7317,
23/02/2015,23/02/2015,0,DEP.EFECTIVO 124601074,0,116,2194.00,,67617.46,7318,
23/02/2015,23/02/2015,100,TRASPASO A CUENTA PROPIA,790,8846,,"$50,000.00",17617.46,7319,"IVA:00000000.00 , A LA CUENTA 0145586351, SUA FENIX AL R.F.C. FVA961108MD7"
23/02/2015,23/02/2015,0,DEP.EFECTIVO 119301057,0,1508,1262.00,,18879.46,7320,
23/02/2015,23/02/2015,0,DEP.EFECTIVO 124601058,0,116,2713.50,,21592.96,7321,
23/02/2015,23/02/2015,0,DEP.EFECTIVO 119301032,0,1508,0.10,,21593.06,7322,
23/02/2015,23/02/2015,0,DEP.EFECTIVO 124601066,0,116,3883.00,,25476.06,7323,
23/02/2015,23/02/2015,0,DEP.EFECTIVO 119301073,0,1508,893.00,,26369.06,7324,
23/02/2015,23/02/2015,0,DEP.EFECTIVO 119301065,0,1508,1781.50,,28150.56,7325,
23/02/2015,23/02/2015,0,DEP.EFECTIVO 133448061,0,2460,2805.50,,30956.06,7326,
23/02/2015,23/02/2015,0,DEP.EFECTIVO 133448079,0,2460,1121.50,,32077.56,7327,
23/02/2015,23/02/2015,0,DEP.EFECTIVO 34602060,0,52,2103.50,,34181.06,7328,
23/02/2015,23/02/2015,0,DEP.EFECTIVO 34602078,0,52,887.00,,35068.06,7329,
23/02/2015,23/02/2015,0,DEP.EFECTIVO 34602052,0,52,1943.50,,37011.56,7330,
23/02/2015,23/02/2015,0,DEP.EFECTIVO 112401065,0,8701,2299.50,,39311.06,7331,
23/02/2015,23/02/2015,0,DEP.EFECTIVO 112401073,0,8701,776.00,,40087.06,7332,
23/02/2015,23/02/2015,0,DEP.EFECTIVO 112401057,0,8701,1437.00,,41524.06,7333,
23/02/2015,23/02/2015,0,DEP.EFECTIVO 106414058,0,8014,2336.00,,43860.06,7334,
23/02/2015,23/02/2015,0,DEP.EFECTIVO 106414074,0,8014,1500.00,,45360.06,7335,
23/02/2015,23/02/2015,0,DEP.EFECTIVO 106414066,0,8014,2737.50,,48097.56,7336,
23/02/2015,23/02/2015,0,DEP.EFECTIVO 121201050,0,275,1747.50,,49845.06,7337,
23/02/2015,23/02/2015,0,DEP.EFECTIVO 121201068,0,275,1604.00,,51449.06,7338,
23/02/2015,23/02/2015,0,DEP.EFECTIVO 121201076,0,275,830.00,,52279.06,7339,
23/02/2015,23/02/2015,0,DEP.EFECTIVO 33402066,0,52,3064.50,,55343.56,7340,
23/02/2015,23/02/2015,0,DEP.EFECTIVO 123601075,0,2306,486.50,,55830.06,7341,
23/02/2015,23/02/2015,0,DEP.EFECTIVO 35102052,0,52,2620.50,,58450.56,7342,
23/02/2015,23/02/2015,0,DEP.EFECTIVO 137001056,0,2049,1774.00,,60224.56,7343,
23/02/2015,23/02/2015,0,DEP.EFECTIVO 123601059,0,2306,1830.50,,62055.06,7344,
23/02/2015,23/02/2015,0,DEP.EFECTIVO 33402074,0,52,1698.50,,63753.56,7345,
23/02/2015,23/02/2015,0,DEP.EFECTIVO 35102060,0,52,2834.00,,66587.56,7346,
23/02/2015,23/02/2015,0,DEP.EFECTIVO 137001064,0,2049,332.00,,66919.56,7347,
23/02/2015,23/02/2015,0,DEP.EFECTIVO 123601067,0,2306,2024.00,,68943.56,7348,
23/02/2015,23/02/2015,0,DEP.EFECTIVO 33402058,0,52,3201.50,,72145.06,7349,
23/02/2015,23/02/2015,0,DEP.EFECTIVO 124601058,0,2009,18.00,,72163.06,7350,
23/02/2015,23/02/2015,0,DEP.EFECTIVO 137001072,0,2049,83.00,,72246.06,7351,
23/02/2015,23/02/2015,0,DEP.EFECTIVO 35102078,0,52,1524.50,,73770.56,7352,
23/02/2015,23/02/2015,0,DEP.EFECTIVO 117001050,0,274,2292.50,,76063.06,7353,
23/02/2015,23/02/2015,0,DEP.EFECTIVO 1090100590,0,8113,4737.90,,80800.96,7354,
23/02/2015,23/02/2015,0,DEP.EFECTIVO 1090110065,0,8113,5820.00,,86620.96,7355,
23/02/2015,23/02/2015,0,DEP.EFECTIVO 1090100716,0,8113,1299.50,,87920.46,7356,
23/02/2015,23/02/2015,0,DEP.EFECTIVO 117001068,0,274,2362.00,,90282.46,7357,
23/02/2015,23/02/2015,0,DEP.EFECTIVO 111501063,0,2290,4356.50,,94638.96,7358,
23/02/2015,23/02/2015,0,DEP.EFECTIVO 1222010132,0,2069,1942.50,,96581.46,7359,
23/02/2015,23/02/2015,0,DEP.EFECTIVO 111501055,0,2290,3239.50,,99820.96,7360,
23/02/2015,23/02/2015,0,DEP.EFECTIVO 122201015,0,2069,3085.50,,102906.46,7361,
23/02/2015,23/02/2015,0,DEP.EFECTIVO 117001076,0,274,374.00,,103280.46,7362,
23/02/2015,23/02/2015,0,DEP.EFECTIVO 111501071,0,2290,2734.80,,106015.26,7363,
23/02/2015,23/02/2015,0,DEP.EFECTIVO 108301057,0,3682,1983.90,,107999.16,7364,
23/02/2015,23/02/2015,0,DEP.EFECTIVO 133201056,0,2183,2364.50,,110363.66,7365,
23/02/2015,23/02/2015,0,DEP.EFECTIVO 108301065,0,3682,2525.70,,112889.36,7366,
23/02/2015,23/02/2015,0,DEP.EFECTIVO 122201017,0,2069,1892.00,,114781.36,7367,
23/02/2015,23/02/2015,0,DEP.EFECTIVO 108301073,0,3682,1722.50,,116503.86,7368,
23/02/2015,23/02/2015,0,DEP.EFECTIVO 133201064,0,2183,1869.50,,118373.36,7369,
23/02/2015,23/02/2015,0,DEP.EFECTIVO 133201072,0,2183,690.50,,119063.86,7370,
23/02/2015,23/02/2015,0,DEP.EFECTIVO 1282030576,0,3190,1356.50,,120420.36,7371,
23/02/2015,23/02/2015,0,DEP.EFECTIVO 1282030799,0,3190,1102.00,,121522.36,7372,
23/02/2015,23/02/2015,0,DEP.EFECTIVO 1282030639,0,3190,1897.50,,123419.86,7373,
23/02/2015,23/02/2015,0,DEP.EFECTIVO 118701073,0,2314,2117.50,,125537.36,7374,
23/02/2015,23/02/2015,0,DEP.EFECTIVO 118701057,0,2314,2219.00,,127756.36,7375,
23/02/2015,23/02/2015,0,DEP.EFECTIVO 118701065,0,2314,3433.50,,131189.86,7376,
23/02/2015,23/02/2015,0,DEP.EFECTIVO 098301057,0,2314,4167.00,,135356.86,7377,
23/02/2015,23/02/2015,0,DEP.EFECTIVO 111024074,0,1490,784.50,,136141.36,7378,
23/02/2015,23/02/2015,0,DEP.EFECTIVO 098301065,0,2314,3864.00,,140005.36,7379,
23/02/2015,23/02/2015,0,DEP.EFECTIVO 111024066,0,1490,1537.50,,141542.86,7380,
23/02/2015,23/02/2015,0,DEP.EFECTIVO 098301073,0,2314,5202.50,,146745.36,7381,
23/02/2015,23/02/2015,0,DEP.EFECTIVO 122701057,0,2325,1429.00,,148174.36,7382,
23/02/2015,23/02/2015,0,DEP.EFECTIVO 122701065,0,2325,1381.00,,149555.36,7383,
23/02/2015,23/02/2015,0,DEP.EFECTIVO 122701073,0,2325,834.50,,150389.86,7384,
23/02/2015,23/02/2015,0,DEP.EFECTIVO 99213053,0,648,3474.50,,153864.36,7385,
23/02/2015,23/02/2015,0,DEP.EFECTIVO 99213061,0,648,4793.50,,158657.86,7386,
23/02/2015,23/02/2015,0,DEP.EFECTIVO 99213079,0,648,717.40,,159375.26,7387,
23/02/2015,23/02/2015,0,DEP.EFECTIVO 13160107,0,117,2000.50,,161375.76,7388,
23/02/2015,23/02/2015,0,DEP.EFECTIVO 13160106,0,117,3633.00,,165008.76,7389,
23/02/2015,23/02/2015,0,DEP.EFECTIVO 13160105,0,117,3557.00,,168565.76,7390,
23/02/2015,23/02/2015,0,DEP.EFECTIVO 124301055,0,1474,1816.00,,170381.76,7391,
23/02/2015,23/02/2015,0,DEP.EFECTIVO 124301063,0,1474,3302.10,,173683.86,7392,
23/02/2015,23/02/2015,0,DEP.EFECTIVO 124301071,0,1474,2882.20,,176566.06,7393,
23/02/2015,23/02/2015,0,DEP.EFECTIVO 96824050,0,1490,4146.50,,180712.56,7394,
23/02/2015,23/02/2015,0,DEP.EFECTIVO 96824068,0,1490,3619.50,,184332.06,7395,
23/02/2015,23/02/2015,0,DEP.EFECTIVO 96824076,0,1490,999.50,,185331.56,7396,
23/02/2015,23/02/2015,0,DEP.EFECTIVO 141001068,0,2009,1951.00,,187282.56,7397,
23/02/2015,23/02/2015,0,DEP.EFECTIVO 141001076,0,2009,1249.00,,188531.56,7398,
23/02/2015,23/02/2015,0,DEP.EFECTIVO 141001050,0,2009,1917.00,,190448.56,7399,
23/02/2015,23/02/2015,0,DEP.EFECTIVO 1000300726,0,2552,1117.00,,191565.56,7400,
23/02/2015,23/02/2015,0,DEP.EFECTIVO 1145300681,0,2552,1600.50,,193166.06,7401,
23/02/2015,23/02/2015,0,DEP.EFECTIVO 1000300663,0,2552,2216.50,,195382.56,7402,
23/02/2015,23/02/2015,0,DEP.EFECTIVO 1145300521,0,2552,1514.00,,196896.56,7403,
23/02/2015,23/02/2015,0,DEP.EFECTIVO 1000300503,0,2552,2858.50,,199755.06,7404,
23/02/2015,23/02/2015,0,DEP.EFECTIVO 126301057,0,464,1966.50,,201721.56,7405,
23/02/2015,23/02/2015,0,DEP.EFECTIVO 1145300744,0,2552,929.50,,202651.06,7406,
23/02/2015,23/02/2015,0,DEP.EFECTIVO 126301073,0,464,1795.50,,204446.56,7407,
23/02/2015,23/02/2015,0,DEP.EFECTIVO 131013073,0,1508,1606.00,,206052.56,7408,
23/02/2015,23/02/2015,0,DEP.EFECTIVO 126301065,0,464,1783.00,,207835.56,7409,
23/02/2015,23/02/2015,0,DEP.EFECTIVO 131013065,0,1508,1460.06,,209295.62,7410,
23/02/2015,23/02/2015,0,DEP.EFECTIVO 131013057,0,1508,3568.50,,212864.12,7411,
23/02/2015,23/02/2015,0,DEP.EFECTIVO 141601073,0,1938,914.00,,213778.12,7412,
23/02/2015,23/02/2015,0,DEP.EFECTIVO 116501065,0,1424,4227.80,,218005.92,7413,
23/02/2015,23/02/2015,0,DEP.EFECTIVO 093001032,0,691,3321.50,,221327.42,7414,
23/02/2015,23/02/2015,0,DEP.EFECTIVO 141601057,0,1938,1745.50,,223072.92,7415,
23/02/2015,23/02/2015,0,DEP.EFECTIVO 116501073,0,1424,1754.50,,224827.42,7416,
23/02/2015,23/02/2015,0,DEP.EFECTIVO 093001073,0,691,2898.90,,227726.32,7417,
23/02/2015,23/02/2015,0,DEP.EFECTIVO 141601065,0,1938,1314.00,,229040.32,7418,
23/02/2015,23/02/2015,0,DEP.EFECTIVO 116501057,0,1424,3616.50,,232656.82,7419,
23/02/2015,23/02/2015,0,DEP.EFECTIVO 093001065,0,691,3838.50,,236495.32,7420,
23/02/2015,23/02/2015,0,DEP.EFECTIVO 137601015,0,1470,5012.50,,241507.82,7421,
23/02/2015,23/02/2015,0,DEP.EFECTIVO 104727078,0,3705,320.00,,241827.82,7422,
23/02/2015,23/02/2015,0,DEP.EFECTIVO 093001057,0,691,3151.00,,244978.82,7423,
23/02/2015,23/02/2015,0,DEP.EFECTIVO 91402050,0,727,2989.00,,247967.82,7424,
23/02/2015,23/02/2015,0,DEP.EFECTIVO 137601013,0,1470,2516.00,,250483.82,7425,
23/02/2015,23/02/2015,0,DEP.EFECTIVO 104727060,0,3705,1547.50,,252031.32,7426,
23/02/2015,23/02/2015,0,DEP.EFECTIVO 137601017,0,1470,2891.50,,254922.82,7427,
23/02/2015,23/02/2015,0,DEP.EFECTIVO 104727052,0,3705,1145.00,,256067.82,7428,
23/02/2015,23/02/2015,0,DEP.EFECTIVO 91402068,0,727,1141.20,,257209.02,7429,
23/02/2015,23/02/2015,0,DEP.EFECTIVO 91402076,0,727,1057.20,,258266.22,7430,
23/02/2015,23/02/2015,0,DEP.EFECTIVO 104901064,0,2092,2586.80,,260853.02,7431,
23/02/2015,23/02/2015,0,DEP.EFECTIVO 104901072,0,2092,1295.50,,262148.52,7432,
23/02/2015,23/02/2015,0,DEP.EFECTIVO 121701059,0,831,1675.00,,263823.52,7433,
23/02/2015,23/02/2015,0,DEP.EFECTIVO 121701067,0,831,304.00,,264127.52,7434,
23/02/2015,23/02/2015,0,DEP.EFECTIVO 104901056,0,2092,3684.00,,267811.52,7435,
23/02/2015,23/02/2015,0,DEP.EFECTIVO 121701075,0,831,1154.00,,268965.52,7436,
23/02/2015,23/02/2015,0,DEP.EFECTIVO 120501073,0,2325,1251.00,,270216.52,7437,
23/02/2015,23/02/2015,0,DEP.EFECTIVO 120501065,0,2325,3058.50,,273275.02,7438,
23/02/2015,23/02/2015,0,DEP.EFECTIVO 101333071,0,3682,2745.80,,276020.82,7439,
23/02/2015,23/02/2015,0,DEP.EFECTIVO 120501057,0,2325,3485.00,,279505.82,7440,
23/02/2015,23/02/2015,0,DEP.EFECTIVO 101333063,0,3682,3444.50,,282950.32,7441,
23/02/2015,23/02/2015,0,DEP.EFECTIVO 101333055,0,3682,3678.20,,286628.52,7442,
23/02/2015,23/02/2015,0,DEP.EFECTIVO 107701073,0,2113,2850.00,,289478.52,7443,
23/02/2015,23/02/2015,0,DEP.EFECTIVO 107701057,0,2113,3208.00,,292686.52,7444,
23/02/2015,23/02/2015,0,DEP.EFECTIVO 107701065,0,2113,2398.00,,295084.52,7445,
23/02/2015,23/02/2015,0,DEP.EFECTIVO 129201013,0,295,1318.50,,296403.02,7446,
23/02/2015,23/02/2015,0,DEP.EFECTIVO 129201015,0,295,1767.00,,298170.02,7447,
23/02/2015,23/02/2015,0,DEP.EFECTIVO 129201017,0,295,2120.50,,300290.52,7448,
23/02/2015,23/02/2015,0,DEP.EFECTIVO 115901046,0,8013,2031.00,,302321.52,7449,
23/02/2015,23/02/2015,0,DEP.EFECTIVO 115901053,0,8013,1688.50,,304010.02,7450,
23/02/2015,23/02/2015,0,DEP.EFECTIVO 115901061,0,8013,1493.50,,305503.52,7451,
23/02/2015,23/02/2015,0,DEP.EFECTIVO 98001061,0,2096,1668.50,,307172.02,7452,
23/02/2015,23/02/2015,0,DEP.EFECTIVO 133301062,0,3,3395.50,,310567.52,7453,
23/02/2015,23/02/2015,0,DEP.EFECTIVO 177351859,0,2043,2549.00,,313116.52,7454,
23/02/2015,23/02/2015,0,DEP.EFECTIVO,0,2096,2068.50,,315185.02,7455,
23/02/2015,23/02/2015,0,DEP.EFECTIVO 133301054,0,3,3104.00,,318289.02,7456,
23/02/2015,23/02/2015,0,DEP.EFECTIVO 98001046,0,2096,2531.00,,320820.02,7457,
23/02/2015,23/02/2015,0,DEP.EFECTIVO 1133010742,0,2043,4961.00,,325781.02,7458,
23/02/2015,23/02/2015,0,DEP.EFECTIVO 133301070,0,3,1226.00,,327007.02,7459,
23/02/2015,23/02/2015,0,DEP.EFECTIVO 98001038,0,2096,1851.00,,328858.02,7460,
23/02/2015,23/02/2015,0,DEP.EFECTIVO 1133010679,0,2043,2522.00,,331380.02,7461,
23/02/2015,23/02/2015,0,ANUL.DEP.EFECTIVO,501,2096,,"$2,068.50",329311.52,7462,
23/02/2015,23/02/2015,0,DEP.EFECTIVO 98001053,0,2096,2068.50,,331380.02,7463,
23/02/2015,23/02/2015,0,DEP.EFECTIVO 95401057,0,295,1850.50,,333230.52,7464,
23/02/2015,23/02/2015,0,DEP.EFECTIVO 954001065,0,295,2749.50,,335980.02,7465,
23/02/2015,23/02/2015,0,DEP.EFECTIVO 95401073,0,295,837.50,,336817.52,7466,
23/02/2015,23/02/2015,0,DEP.EFECTIVO 113201050,0,2331,4174.00,,340991.52,7467,
23/02/2015,23/02/2015,0,DEP.EFECTIVO 119101073,0,2126,1301.00,,342292.52,7468,
23/02/2015,23/02/2015,0,DEP.EFECTIVO 119101065,0,2126,1887.00,,344179.52,7469,
23/02/2015,23/02/2015,0,DEP.EFECTIVO 113201068,0,2331,2235.00,,346414.52,7470,
23/02/2015,23/02/2015,0,DEP.EFECTIVO 119101057,0,2126,1901.50,,348316.02,7471,
23/02/2015,23/02/2015,0,DEP.EFECTIVO 113201076,0,2331,1722.00,,350038.02,7472,
23/02/2015,23/02/2015,0,DEP.EFECTIVO,0,1334,4231.50,,354269.52,7473,
23/02/2015,23/02/2015,0,DEP.EFECTIVO 103409069,0,7450,1377.40,,355646.92,7474,
23/02/2015,23/02/2015,0,DEP.EFECTIVO 117101074,0,1334,996.50,,356643.42,7475,
23/02/2015,23/02/2015,0,DEP.EFECTIVO 103409077,0,7450,767.00,,357410.42,7476,
23/02/2015,23/02/2015,0,DEP.EFECTIVO 117101058,0,1334,3213.50,,360623.92,7477,
23/02/2015,23/02/2015,0,DEP.EFECTIVO 103409051,0,7450,1437.35,,362061.27,7478,
23/02/2015,23/02/2015,0,DEP.EFECTIVO 102914077,0,8015,1917.50,,363978.77,7479,
23/02/2015,23/02/2015,0,DEP.EFECTIVO 102914069,0,8015,2268.00,,366246.77,7480,
23/02/2015,23/02/2015,0,DEP.EFECTIVO 102914051,0,8015,1576.00,,367822.77,7481,
23/02/2015,23/02/2015,0,DEP.EFECTIVO 099101017,0,1934,5087.50,,372910.27,7482,
23/02/2015,23/02/2015,0,DEP.EFECTIVO 099101015,0,1934,4147.50,,377057.77,7483,
23/02/2015,23/02/2015,0,DEP.EFECTIVO 150401073,0,2043,861.50,,377919.27,7484,
23/02/2015,23/02/2015,0,DEP.EFECTIVO 92508061,0,3630,4211.60,,382130.87,7485,
23/02/2015,23/02/2015,0,DEP.EFECTIVO 099101013,0,1934,2386.50,,384517.37,7486,
23/02/2015,23/02/2015,0,DEP.EFECTIVO 150401057,0,2043,3274.00,,387791.37,7487,
23/02/2015,23/02/2015,0,DEP.EFECTIVO 92508079,0,3630,3322.50,,391113.87,7488,
23/02/2015,23/02/2015,0,DEP.EFECTIVO 150401065,0,2043,3218.00,,394331.87,7489,
23/02/2015,23/02/2015,0,DEP.EFECTIVO 92508053,0,3630,3448.50,,397780.37,7490,
23/02/2015,23/02/2015,0,DEP.EFECTIVO 96901072,0,2043,1620.00,,399400.37,7491,
23/02/2015,23/02/2015,0,DEP.EFECTIVO 96901064,0,2043,2956.50,,402356.87,7492,
23/02/2015,23/02/2015,0,DEP.EFECTIVO 121801040,0,2547,1378.50,,403735.37,7493,
23/02/2015,23/02/2015,0,DEP.EFECTIVO 121801057,0,2547,912.00,,404647.37,7494,
23/02/2015,23/02/2015,0,DEP.EFECTIVO 121801065,0,2547,1327.00,,405974.37,7495,
23/02/2015,23/02/2015,0,DEP.EFECTIVO 121801073,0,2547,787.00,,406761.37,7496,
24/02/2015,24/02/2015,200,TRASPASO A CUENTA PROPIA,790,8846,,"$406,761.37",0.00,7497,"IVA:00000000.00 , A LA CUENTA 0136679699, 200 AL R.F.C. FTI9211036K2"
24/02/2015,24/02/2015,0,DEP.EFECTIVO 107701016,0,2306,3141.00,,3141.00,7498,
24/02/2015,24/02/2015,0,DEP.EFECTIVO 131801014,0,2162,5990.00,,9131.00,7499,
24/02/2015,24/02/2015,0,DEP.EFECTIVO 119101016,0,2126,1654.00,,10785.00,7500,
24/02/2015,24/02/2015,0,DEP.EFECTIVO 117001019,0,274,1961.50,,12746.50,7501,
24/02/2015,24/02/2015,0,DEP.EFECTIVO 105122048,0,1976,6391.00,,19137.50,7502,
24/02/2015,24/02/2015,0,DEP.EFECTIVO 105122055,0,1976,1312.00,,20449.50,7503,
24/02/2015,24/02/2015,0,DEP.EFECTIVO 105122063,0,1976,1291.00,,21740.50,7504,
24/02/2015,24/02/2015,0,DEP.EFECTIVO 137001015,0,2049,1457.50,,23198.00,7505,
24/02/2015,24/02/2015,0,DEP.EFECTIVO 102101014,0,706,2405.00,,25603.00,7506,
24/02/2015,24/02/2015,0,DEP.EFECTIVO 110501016,0,8011,3420.50,,29023.50,7507,
24/02/2015,24/02/2015,0,DEP.EFECTIVO 133301013,0,3,2825.00,,31848.50,7508,
24/02/2015,24/02/2015,0,DEP.EFECTIVO 094301016,0,1938,1760.00,,33608.50,7509,
24/02/2015,24/02/2015,0,DEP.EFECTIVO,0,2162,2802.00,,36410.50,7510,
24/02/2015,24/02/2015,0,DEP.EFECTIVO 124601074,0,2009,3335.00,,39745.50,7511,
24/02/2015,24/02/2015,0,DEP.EFECTIVO 141001019,0,2009,1523.50,,41269.00,7512,
24/02/2015,24/02/2015,0,DEP.EFECTIVO 123601018,0,2306,1215.00,,42484.00,7513,
24/02/2015,24/02/2015,0,DEP.EFECTIVO 108204010,0,188,2648.00,,45132.00,7514,
24/02/2015,24/02/2015,0,DEP.EFECTIVO 113201019,0,2331,4923.00,,50055.00,7515,
24/02/2015,24/02/2015,0,DEP.EFECTIVO 117101017,0,2162,3804.50,,53859.50,7516,
24/02/2015,24/02/2015,0,DEP.EFECTIVO 098301016,0,2314,6761.50,,60621.00,7517,
24/02/2015,24/02/2015,0,DEP.EFECTIVO 118701016,0,2314,2974.50,,63595.50,7518,
24/02/2015,24/02/2015,0,DEP.EFECTIVO 124301014,0,1474,2917.00,,66512.50,7519,
24/02/2015,24/02/2015,0,DEP.EFECTIVO 121201019,0,275,1678.00,,68190.50,7520,
24/02/2015,24/02/2015,0,DEP.EFECTIVO 106414017,0,8014,2738.50,,70929.00,7521,
24/02/2015,24/02/2015,0,DEP.EFECTIVO 133448020,0,2460,4572.50,,75501.50,7522,
24/02/2015,24/02/2015,0,DEP.EFECTIVO 35102011,0,52,1939.00,,77440.50,7523,
24/02/2015,24/02/2015,0,DEP.EFECTIVO 108301016,0,3682,2749.30,,80189.80,7524,
24/02/2015,24/02/2015,0,DEP.EFECTIVO 122201016,0,2069,2370.50,,82560.30,7525,
24/02/2015,24/02/2015,0,DEP.EFECTIVO 98001038,0,1477,22.50,,82582.80,7526,
24/02/2015,24/02/2015,0,DEP.EFECTIVO 98001079,0,1477,2401.00,,84983.80,7527,
24/02/2015,24/02/2015,0,ANUL.DEP.EFECTIVO 13344,501,2460,,"$4,572.50",80411.30,7528,
24/02/2015,24/02/2015,0,DEP.EFECTIVO 133448012,0,2460,4572.50,,84983.80,7529,
24/02/2015,24/02/2015,0,DEP.EFECTIVO 121801016,0,2162,1333.00,,86316.80,7530,
24/02/2015,24/02/2015,0,DEP.EFECTIVO 126301016,0,464,2932.00,,89248.80,7531,
24/02/2015,24/02/2015,0,DEP.EFECTIVO 150401016,0,2043,4151.50,,93400.30,7532,
24/02/2015,24/02/2015,0,DEP.EFECTIVO 99213012,0,648,4735.00,,98135.30,7533,
24/02/2015,24/02/2015,0,DEP.EFECTIVO 1282030130,0,3190,3015.00,,101150.30,7534,
24/02/2015,24/02/2015,0,DEP.EFECTIVO 117513013,0,1566,1944.00,,103094.30,7535,
24/02/2015,24/02/2015,0,DEP.EFECTIVO 041201016,0,2325,3165.00,,106259.30,7536,
24/02/2015,24/02/2015,0,DEP.EFECTIVO 1090100144,0,8117,6047.00,,112306.30,7537,
24/02/2015,24/02/2015,0,DEP.EFECTIVO 133201015,0,2183,2086.00,,114392.30,7538,
24/02/2015,24/02/2015,0,DEP.EFECTIVO 104901015,0,2092,4766.00,,119158.30,7539,
24/02/2015,24/02/2015,0,DEP.EFECTIVO 92508012,0,3630,4435.50,,123593.80,7540,
24/02/2015,24/02/2015,0,DEP.EFECTIVO 1000300154,0,2552,3099.50,,126693.30,7541,
24/02/2015,24/02/2015,0,DEP.EFECTIVO 1114130104,0,1974,5253.00,,131946.30,7542,
24/02/2015,24/02/2015,0,DEP.EFECTIVO 111024017,0,1490,1565.50,,133511.80,7543,
24/02/2015,24/02/2015,0,DEP.EFECTIVO 104727011,0,3705,1772.50,,135284.30,7544,
24/02/2015,24/02/2015,0,DEP.EFECTIVO 119613019,0,7726,471.50,,135755.80,7545,
24/02/2015,24/02/2015,0,DEP.EFECTIVO 91402019,0,727,1450.20,,137206.00,7546,
24/02/2015,24/02/2015,0,DEP.EFECTIVO 119613076,0,7726,643.90,,137849.90,7547,
24/02/2015,24/02/2015,0,DEP.EFECTIVO 1209130110,0,1536,1700.20,,139550.10,7548,
24/02/2015,24/02/2015,0,DEP.EFECTIVO 116501016,0,1424,5471.00,,145021.10,7549,
24/02/2015,24/02/2015,0,DEP.EFECTIVO 121701018,0,831,1568.00,,146589.10,7550,
24/02/2015,24/02/2015,0,DEP.EFECTIVO 093001016,0,691,4039.70,,150628.80,7551,
24/02/2015,24/02/2015,0,DEP.EFECTIVO 124901011,0,2104,4259.00,,154887.80,7552,
24/02/2015,24/02/2015,0,DEP.EFECTIVO 1133010170,0,2043,3528.00,,158415.80,7553,
24/02/2015,24/02/2015,0,DEP.EFECTIVO 33402017,0,52,1501.00,,159916.80,7554,
24/02/2015,24/02/2015,0,DEP.EFECTIVO 96824019,0,1490,5298.50,,165215.30,7555,
24/02/2015,24/02/2015,0,DEP.EFECTIVO 34602011,0,143,1702.50,,166917.80,7556,
24/02/2015,24/02/2015,0,DEP.EFECTIVO 101333014,0,3682,4842.50,,171760.30,7557,
24/02/2015,24/02/2015,0,DEP.EFECTIVO 120501016,0,2382,4342.00,,176102.30,7558,
24/02/2015,24/02/2015,0,DEP.EFECTIVO 122701016,0,2382,1909.00,,178011.30,7559,
24/02/2015,24/02/2015,0,DEPOSITO DE CUENTA DE TERCEROS,0,4253,1173.60,,179184.90,7560,"DEPOSITO EFECTIVO OFICINA TELECOMM 30035, REFERENCIA CLIENTE 0000000000"
24/02/2015,24/02/2015,0,DEP.EFECTIVO 129201016,0,295,2777.50,,181962.40,7561,
24/02/2015,24/02/2015,0,DEPOSITO DE CUENTA DE TERCEROS,0,4253,1071.30,,183033.70,7562,"DEPOSITO EFECTIVO OFICINA TELECOMM 30035, REFERENCIA CLIENTE 0000000000"
24/02/2015,24/02/2015,0,DEP.EFECTIVO 111501014,0,2290,4465.00,,187498.70,7563,
24/02/2015,24/02/2015,0,DEP.EFECTIVO 102210013,0,8114,3690.40,,191189.10,7564,
24/02/2015,24/02/2015,0,DEPOSITO DE CUENTA DE TERCEROS,0,4253,1981.80,,193170.90,7565,"DEPOSITO EFECTIVO OFICINA TELECOMM 30035, REFERENCIA CLIENTE 0000000000"
24/02/2015,24/02/2015,0,DEP.EFECTIVO 117901010,0,2067,1931.10,,195102.00,7566,
24/02/2015,24/02/2015,0,DEPOSITO DE CUENTA DE TERCEROS,0,4253,879.95,,195981.95,7567,"DEPOSITO EFECTIVO OFICINA TELECOMM 30035, REFERENCIA CLIENTE 0000000000"
24/02/2015,24/02/2015,0,DEPOSITO DE CUENTA DE TERCEROS,0,4253,2359.70,,198341.65,7568,"DEPOSITO EFECTIVO OFICINA TELECOMM 30035, REFERENCIA CLIENTE 0000000000"
24/02/2015,24/02/2015,0,DEP.EFECTIVO 13160101,0,2162,2806.20,,201147.85,7569,
24/02/2015,24/02/2015,0,DEP.EFECTIVO 137601016,0,1470,5958.00,,207105.85,7570,
24/02/2015,24/02/2015,0,DEP.EFECTIVO 141601016,0,2162,1502.00,,208607.85,7571,
24/02/2015,24/02/2015,0,DEP.EFECTIVO 103409010,0,7450,1599.50,,210207.35,7572,
24/02/2015,24/02/2015,0,DEP.EFECTIVO 95401016,0,295,3454.50,,213661.85,7573,
24/02/2015,24/02/2015,0,DEP.EFECTIVO 115901012,0,8013,2181.50,,215843.35,7574,
24/02/2015,24/02/2015,0,DEP.EFECTIVO 119301016,0,1536,2361.50,,218204.85,7575,
24/02/2015,24/02/2015,0,DEP.EFECTIVO 099101016,0,1934,2706.00,,220910.85,7576,
24/02/2015,24/02/2015,0,DEP.EFECTIVO 102914010,0,8015,1884.00,,222794.85,7577,
24/02/2015,24/02/2015,0,DEP.EFECTIVO 112401016,0,8717,1384.00,,224178.85,7578,
25/02/2015,25/02/2015,0,DEP.EFECTIVO 133448020,0,2460,2241.00,,226419.85,7579,
25/02/2015,25/02/2015,200,TRASPASO A CUENTA PROPIA,790,8846,,"$226,419.84",0.01,7580,"IVA:00000000.00 , A LA CUENTA 0136679699, 200 AL R.F.C. FTI9211036K2"
25/02/2015,25/02/2015,0,DEP.EFECTIVO 106414025,0,8014,1679.50,,1679.51,7581,
25/02/2015,25/02/2015,0,DEP.EFECTIVO 124301022,0,1474,2689.00,,4368.51,7582,
25/02/2015,25/02/2015,0,DEP.EFECTIVO 110501024,0,8014,2371.00,,6739.51,7583,
25/02/2015,25/02/2015,0,DEP.EFECTIVO 102914028,0,8015,1921.50,,8661.01,7584,
25/02/2015,25/02/2015,0,DEP.EFECTIVO 105122014,0,1976,1177.00,,9838.01,7585,
25/02/2015,25/02/2015,0,DEP.EFECTIVO 094301024,0,1938,2593.00,,12431.01,7586,
25/02/2015,25/02/2015,0,DEP.EFECTIVO 108204028,0,188,3478.50,,15909.51,7587,
25/02/2015,25/02/2015,0,DEP.EFECTIVO 123601026,0,2306,1157.00,,17066.51,7588,
25/02/2015,25/02/2015,0,DEP.EFECTIVO 124601025,0,116,3424.50,,20491.01,7589,
25/02/2015,25/02/2015,0,DEP.EFECTIVO 117101025,0,1334,3265.50,,23756.51,7590,
25/02/2015,25/02/2015,0,DEP.EFECTIVO 117101017,0,1334,10.00,,23766.51,7591,
25/02/2015,25/02/2015,0,DEP.EFECTIVO 92508020,0,3630,4452.00,,28218.51,7592,
25/02/2015,25/02/2015,0,DEP.EFECTIVO 117001027,0,274,3256.00,,31474.51,7593,
25/02/2015,25/02/2015,0,DEP.EFECTIVO 13807026,0,2605,2532.00,,34006.51,7594,
25/02/2015,25/02/2015,0,DEP.EFECTIVO 121201027,0,275,2472.00,,36478.51,7595,
25/02/2015,25/02/2015,0,DEP.EFECTIVO 1282030290,0,3190,1844.50,,38323.01,7596,
25/02/2015,25/02/2015,0,DEP.EFECTIVO 137001023,0,2049,1479.50,,39802.51,7597,
25/02/2015,25/02/2015,0,DEP.EFECTIVO 133201023,0,2183,1975.50,,41778.01,7598,
25/02/2015,25/02/2015,0,DEP.EFECTIVO 111024025,0,1490,1129.50,,42907.51,7599,
25/02/2015,25/02/2015,0,DEP.EFECTIVO 96824027,0,1490,3432.00,,46339.51,7600,
25/02/2015,25/02/2015,0,DEP.EFECTIVO 102210021,0,8114,1370.00,,47709.51,7601,
25/02/2015,25/02/2015,0,DEP.EFECTIVO 118701024,0,2314,3791.50,,51501.01,7602,
25/02/2015,25/02/2015,0,DEP.EFECTIVO 35102029,0,52,1679.00,,53180.01,7603,
25/02/2015,25/02/2015,0,DEP.EFECTIVO 108301024,0,3682,2740.10,,55920.11,7604,
25/02/2015,25/02/2015,0,DEP.EFECTIVO 098301024,0,2314,3579.00,,59499.11,7605,
25/02/2015,25/02/2015,0,DEP.EFECTIVO 33402025,0,52,2529.00,,62028.11,7606,
25/02/2015,25/02/2015,0,DEP.EFECTIVO 041201024,0,2325,3728.50,,65756.61,7607,
25/02/2015,25/02/2015,0,DEP.EFECTIVO,0,143,1567.00,,67323.61,7608,
25/02/2015,25/02/2015,0,DEP.EFECTIVO 141001027,0,2009,1457.00,,68780.61,7609,
25/02/2015,25/02/2015,0,ANUL.DEP.EFECTIVO,501,143,,"$1,567.00",67213.61,7610,
25/02/2015,25/02/2015,0,DEP.EFECTIVO 34602029,0,143,1567.00,,68780.61,7611,
25/02/2015,25/02/2015,0,DEP.EFECTIVO 117513021,0,1566,1590.00,,70370.61,7612,
25/02/2015,25/02/2015,0,DEP.EFECTIVO 113201027,0,2331,3671.50,,74042.11,7613,
25/02/2015,25/02/2015,0,DEP.EFECTIVO 131801022,0,2102,4700.00,,78742.11,7614,
25/02/2015,25/02/2015,0,DEP.EFECTIVO 122201012,0,2069,1917.50,,80659.61,7615,
25/02/2015,25/02/2015,0,DEP.EFECTIVO 121701026,0,831,1177.00,,81836.61,7616,
25/02/2015,25/02/2015,0,DEP.EFECTIVO 104727029,0,3705,1240.00,,83076.61,7617,
25/02/2015,25/02/2015,0,DEP.EFECTIVO 177351859,0,1424,2422.08,,85498.69,7618,
25/02/2015,25/02/2015,0,DEP.EFECTIVO 13160102,0,117,1938.00,,87436.69,7619,
25/02/2015,25/02/2015,0,DEP.EFECTIVO 122701024,0,2325,1763.00,,89199.69,7620,
25/02/2015,25/02/2015,0,ANUL.DEP.EFECTIVO 17735,501,1424,,"$2,422.08",86777.61,7621,
25/02/2015,25/02/2015,0,DEP.EFECTIVO 91402027,0,727,1998.70,,88776.31,7622,
25/02/2015,25/02/2015,0,DEP.EFECTIVO 131013024,0,166,1241.50,,90017.81,7623,
25/02/2015,25/02/2015,0,DEP.EFECTIVO 116501024,0,1424,2422.08,,92439.89,7624,
25/02/2015,25/02/2015,0,DEP.EFECTIVO 131013016,0,166,2916.00,,95355.89,7625,
25/02/2015,25/02/2015,0,DEP.EFECTIVO 99213020,0,648,2656.50,,98012.39,7626,
25/02/2015,25/02/2015,0,DEP.EFECTIVO 123501028,0,2104,1950.50,,99962.89,7627,
25/02/2015,25/02/2015,0,DEP.EFECTIVO 1209130270,0,1536,1070.00,,101032.89,7628,
25/02/2015,25/02/2015,0,DEP.EFECTIVO 137601014,0,1470,2674.50,,103707.39,7629,
25/02/2015,25/02/2015,0,DEP.EFECTIVO 133301021,0,274,3156.00,,106863.39,7630,
25/02/2015,25/02/2015,0,DEP.EFECTIVO,0,7726,1616.00,,108479.39,7631,
25/02/2015,25/02/2015,0,ANUL.DEP.EFECTIVO,501,7726,,"$1,616.00",106863.39,7632,
25/02/2015,25/02/2015,0,DEP.EFECTIVO 119613027,0,7726,1616.00,,108479.39,7633,
25/02/2015,25/02/2015,0,DEP.EFECTIVO 093001024,0,691,3024.00,,111503.39,7634,
25/02/2015,25/02/2015,0,DEP.EFECTIVO 150401024,0,2043,3438.50,,114941.89,7635,
25/02/2015,25/02/2015,0,DEP.EFECTIVO 124901029,0,2104,2608.00,,117549.89,7636,
25/02/2015,25/02/2015,0,DEP.EFECTIVO 120501024,0,2325,3389.50,,120939.39,7637,
25/02/2015,25/02/2015,0,DEP.EFECTIVO 129201014,0,295,2817.00,,123756.39,7638,
25/02/2015,25/02/2015,0,DEP.EFECTIVO 117901028,0,2067,2216.00,,125972.39,7639,
25/02/2015,25/02/2015,0,DEP.EFECTIVO 1000300217,0,2552,1502.50,,127474.89,7640,
25/02/2015,25/02/2015,0,DEP.EFECTIVO 119101024,0,2126,2972.50,,130447.39,7641,
25/02/2015,25/02/2015,0,DEP.EFECTIVO 1145300235,0,2552,1193.00,,131640.39,7642,
25/02/2015,25/02/2015,0,DEP.EFECTIVO 1145300172,0,2552,2277.00,,133917.39,7643,
25/02/2015,25/02/2015,0,DEP.EFECTIVO 111501022,0,2290,3588.00,,137505.39,7644,
25/02/2015,25/02/2015,0,DEP.EFECTIVO 101333022,0,3682,4428.90,,141934.29,7645,
25/02/2015,25/02/2015,0,DEP.EFECTIVO 119301024,0,1536,1541.00,,143475.29,7646,
25/02/2015,25/02/2015,0,DEP.EFECTIVO 115901020,0,8013,2177.00,,145652.29,7647,
25/02/2015,25/02/2015,0,DEP.EFECTIVO 96901023,0,2043,2628.50,,148280.79,7648,
25/02/2015,25/02/2015,0,DEP.EFECTIVO 96901015,0,2043,3650.50,,151931.29,7649,
25/02/2015,25/02/2015,0,DEP.EFECTIVO 099101014,0,1934,1678.00,,153609.29,7650,
25/02/2015,25/02/2015,0,DEP.EFECTIVO,0,7450,1394.60,,155003.89,7651,
25/02/2015,25/02/2015,0,DEP.EFECTIVO 95401024,0,295,2038.50,,157042.39,7652,
25/02/2015,25/02/2015,0,DEP.EFECTIVO 126301024,0,464,3274.50,,160316.89,7653,
25/02/2015,25/02/2015,0,DEP.EFECTIVO 104901023,0,2092,4249.00,,164565.89,7654,
25/02/2015,25/02/2015,0,DEP.EFECTIVO 1133010233,0,2043,3814.00,,168379.89,7655,
25/02/2015,25/02/2015,0,DEP.EFECTIVO 107701024,0,2113,2678.50,,171058.39,7656,
25/02/2015,25/02/2015,0,DEP.EFECTIVO 141601024,0,1938,1076.50,,172134.89,7657,
25/02/2015,25/02/2015,0,DEP.EFECTIVO 102101022,0,1581,2113.00,,174247.89,7658,
25/02/2015,25/02/2015,0,DEP.EFECTIVO 105122022,0,1976,1325.00,,175572.89,7659,
25/02/2015,25/02/2015,0,DEP.EFECTIVO 121801024,0,2547,1360.00,,176932.89,7660,
25/02/2015,25/02/2015,0,DEP.EFECTIVO 112401024,0,8717,1173.00,,178105.89,7661,
25/02/2015,25/02/2015,0,DEP.EFECTIVO 1090100207,0,8113,5380.50,,183486.39,7662,
26/02/2015,26/02/2015,200,TRASPASO A CUENTA PROPIA,790,8846,,"$183,486.39",0.00,7663,"IVA:00000000.00 , A LA CUENTA 0136679699, 200 AL R.F.C. FTI9211036K2"
26/02/2015,26/02/2015,0,DEP.EFECTIVO 0131801030,0,2102,5693.50,,5693.50,7664,
26/02/2015,26/02/2015,0,DEP.EFECTIVO 108204036,0,188,1645.70,,7339.20,7665,
26/02/2015,26/02/2015,0,DEP.EFECTIVO 126301032,0,464,2617.50,,9956.70,7666,
26/02/2015,26/02/2015,0,DEP.EFECTIVO 34602037,0,143,2306.50,,12263.20,7667,
26/02/2015,26/02/2015,0,DEP.EFECTIVO 1282030353,0,3190,608.50,,12871.70,7668,
26/02/2015,26/02/2015,0,DEP.EFECTIVO 113201027,0,2331,20.00,,12891.70,7669,
26/02/2015,26/02/2015,0,DEP.EFECTIVO 113201068,0,2331,30.00,,12921.70,7670,
26/02/2015,26/02/2015,0,DEP.EFECTIVO 124601033,0,116,2987.00,,15908.70,7671,
26/02/2015,26/02/2015,0,DEP.EFECTIVO 094301032,0,1938,2184.00,,18092.70,7672,
26/02/2015,26/02/2015,0,DEP.EFECTIVO 123601034,0,2306,1213.50,,19306.20,7673,
26/02/2015,26/02/2015,0,DEP.EFECTIVO 122201012,0,2069,1746.00,,21052.20,7674,
26/02/2015,26/02/2015,0,DEP.EFECTIVO 35102037,0,52,1818.60,,22870.80,7675,
26/02/2015,26/02/2015,0,DEP.EFECTIVO,0,7461,1689.00,,24559.80,7676,
26/02/2015,26/02/2015,0,DEP.EFECTIVO 098301032,0,2314,4591.50,,29151.30,7677,
26/02/2015,26/02/2015,0,DEP.EFECTIVO 119301032,0,1536,1738.00,,30889.30,7678,
26/02/2015,26/02/2015,0,DEP.EFECTIVO 33402033,0,52,1957.00,,32846.30,7679,
26/02/2015,26/02/2015,0,DEP.EFECTIVO 13807034,0,2605,2951.00,,35797.30,7680,
26/02/2015,26/02/2015,0,DEP.EFECTIVO 108301032,0,3682,2816.40,,38613.70,7681,
26/02/2015,26/02/2015,0,DEP.EFECTIVO 13807034,0,2605,146.30,,38760.00,7682,
26/02/2015,26/02/2015,0,DEP.EFECTIVO 118701032,0,2314,2669.60,,41429.60,7683,
26/02/2015,26/02/2015,0,DEP.EFECTIVO 121201035,0,275,2442.00,,43871.60,7684,
26/02/2015,26/02/2015,0,DEP.EFECTIVO 99213038,0,648,3980.50,,47852.10,7685,
26/02/2015,26/02/2015,0,DEP.EFECTIVO 137001031,0,2049,1169.00,,49021.10,7686,
26/02/2015,26/02/2015,0,DEP.EFECTIVO 124301030,0,1474,2086.00,,51107.10,7687,
26/02/2015,26/02/2015,0,DEP.EFECTIVO,0,8113,3122.70,,54229.80,7688,
26/02/2015,26/02/2015,0,DEP.EFECTIVO 122701032,0,2325,1704.50,,55934.30,7689,
26/02/2015,26/02/2015,0,DEP.EFECTIVO 112401032,0,8701,1581.00,,57515.30,7690,
26/02/2015,26/02/2015,0,DEP.EFECTIVO 96824035,0,1490,3704.50,,61219.80,7691,
26/02/2015,26/02/2015,0,DEP.EFECTIVO 111024033,0,1490,1352.00,,62571.80,7692,
26/02/2015,26/02/2015,0,DEP.EFECTIVO 13160103,0,117,3096.50,,65668.30,7693,
26/02/2015,26/02/2015,0,DEP.EFECTIVO 123501036,0,2104,2005.00,,67673.30,7694,
26/02/2015,26/02/2015,0,DEP.EFECTIVO 041201032,0,2325,3948.50,,71621.80,7695,
26/02/2015,26/02/2015,0,DEP.EFECTIVO 117513039,0,1566,1829.00,,73450.80,7696,
26/02/2015,26/02/2015,0,DEP.EFECTIVO 91402035,0,727,2297.70,,75748.50,7697,
26/02/2015,26/02/2015,0,DEP.EFECTIVO 133448038,0,2460,4083.50,,79832.00,7698,
26/02/2015,26/02/2015,0,DEP.EFECTIVO 1209130333,0,1536,1887.50,,81719.50,7699,
26/02/2015,26/02/2015,0,DEP.EFECTIVO 101333030,0,3682,4623.80,,86343.30,7700,
26/02/2015,26/02/2015,0,DEP.EFECTIVO 117001035,0,274,3209.50,,89552.80,7701,
26/02/2015,26/02/2015,0,DEP.EFECTIVO 133301039,0,274,2405.00,,91957.80,7702,
26/02/2015,26/02/2015,0,DEP.EFECTIVO 104727037,0,3705,1930.50,,93888.30,7703,
26/02/2015,26/02/2015,0,DEP.EFECTIVO 141001035,0,2009,2570.50,,96458.80,7704,
26/02/2015,26/02/2015,0,DEP.EFECTIVO 1332201031,0,2183,1950.00,,98408.80,7705,
26/02/2015,26/02/2015,0,DEP.EFECTIVO 119613035,0,7726,1276.85,,99685.65,7706,
26/02/2015,26/02/2015,0,DEP.EFECTIVO 137601012,0,2054,4715.00,,104400.65,7707,
26/02/2015,26/02/2015,0,DEP.EFECTIVO 117901036,0,2067,2465.50,,106866.15,7708,
26/02/2015,26/02/2015,0,DEP.EFECTIVO 1114130264,0,1974,2637.90,,109504.05,7709,
26/02/2015,26/02/2015,0,DEP.EFECTIVO 1114130327,0,1974,2115.00,,111619.05,7710,
26/02/2015,26/02/2015,0,DEP.EFECTIVO 1000300377,0,2552,1566.00,,113185.05,7711,
26/02/2015,26/02/2015,0,DEP.EFECTIVO 1145300395,0,2552,1258.00,,114443.05,7712,
26/02/2015,26/02/2015,0,DEP.EFECTIVO 96901031,0,2043,1619.50,,116062.55,7713,
26/02/2015,26/02/2015,0,DEP.EFECTIVO 111501030,0,2290,3814.30,,119876.85,7714,
26/02/2015,26/02/2015,0,DEP.EFECTIVO 124901037,0,2104,3809.00,,123685.85,7715,
26/02/2015,26/02/2015,0,DEP.EFECTIVO 102210039,0,8114,2773.50,,126459.35,7716,
26/02/2015,26/02/2015,0,DEP.EFECTIVO 121701034,0,831,834.50,,127293.85,7717,
26/02/2015,26/02/2015,0,DEP.EFECTIVO 095401032,0,295,2650.00,,129943.85,7718,
26/02/2015,26/02/2015,0,DEP.EFECTIVO 120501032,0,2325,3384.00,,133327.85,7719,
26/02/2015,26/02/2015,0,DEP.EFECTIVO 107701032,0,2113,3499.00,,136826.85,7720,
26/02/2015,26/02/2015,0,DEP.EFECTIVO 116501032,0,1424,3350.50,,140177.35,7721,
26/02/2015,26/02/2015,0,DEP.EFECTIVO 1133010393,0,2043,4105.50,,144282.85,7722,
26/02/2015,26/02/2015,0,DEP.EFECTIVO 113201035,0,2331,5981.50,,150264.35,7723,
26/02/2015,26/02/2015,0,DEP.EFECTIVO 117101033,0,1334,2536.50,,152800.85,7724,
26/02/2015,26/02/2015,0,DEP.EFECTIVO 102914036,0,8015,1755.50,,154556.35,7725,
26/02/2015,26/02/2015,0,DEP.EFECTIVO 129201012,0,295,1730.50,,156286.85,7726,
26/02/2015,26/02/2015,0,DEP.EFECTIVO 150401032,0,2043,2212.50,,158499.35,7727,
26/02/2015,26/02/2015,0,DEP.EFECTIVO 093001032,0,691,3553.50,,162052.85,7728,
26/02/2015,26/02/2015,0,DEP.EFECTIVO 115901038,0,8013,1973.00,,164025.85,7729,
26/02/2015,26/02/2015,0,DEP.EFECTIVO 106414033,0,8014,1984.00,,166009.85,7730,
26/02/2015,26/02/2015,0,DEP.EFECTIVO 119101032,0,464,2260.00,,168269.85,7731,
26/02/2015,26/02/2015,0,DEP.EFECTIVO 099101012,0,1934,3403.00,,171672.85,7732,
26/02/2015,26/02/2015,0,DEP.EFECTIVO 102101030,0,706,1766.00,,173438.85,7733,
26/02/2015,26/02/2015,0,DEP.EFECTIVO 141601032,0,1938,2075.50,,175514.35,7734,
26/02/2015,26/02/2015,0,DEP.EFECTIVO 104901031,0,2092,3597.50,,179111.85,7735,
26/02/2015,26/02/2015,0,DEP.EFECTIVO 121801032,0,690,1382.00,,180493.85,7736,
26/02/2015,26/02/2015,0,DEP.EFECTIVO 105122030,0,1976,1063.00,,181556.85,7737,
26/02/2015,26/02/2015,0,DEP.EFECTIVO 92508038,0,3630,2464.00,,184020.85,7738,
26/02/2015,26/02/2015,0,DEP.EFECTIVO 110501032,0,8014,3803.50,,187824.35,7739,
26/02/2015,26/02/2015,0,ANUL.DEP.EFECTIVO,501,8113,,"$3,122.70",184701.65,7740,
26/02/2015,26/02/2015,0,DEP.EFECTIVO 1090100430,0,8113,3122.70,,187824.35,7741,
27/02/2015,27/02/2015,200,TRASPASO A CUENTA PROPIA,790,8846,,"$187,824.34",0.01,7742,"IVA:00000000.00 , A LA CUENTA 0136679699, 200 AL R.F.C. FTI9211036K2"
27/02/2015,27/02/2015,0,DEP.EFECTIVO 102101048,0,706,2576.00,,2576.01,7743,
27/02/2015,27/02/2015,0,DEPOSITO DE CUENTA DE TERCEROS,0,4253,2204.70,,4780.71,7744,"DEPOSITO EFECTIVO OFICINA TELECOMM 30035, REFERENCIA CLIENTE 0000000000"
27/02/2015,27/02/2015,0,DEPOSITO DE CUENTA DE TERCEROS,0,4253,1420.50,,6201.21,7745,"DEPOSITO EFECTIVO OFICINA TELECOMM 30035, REFERENCIA CLIENTE 0000000000"
27/02/2015,27/02/2015,0,DEPOSITO DE CUENTA DE TERCEROS,0,4253,623.00,,6824.21,7746,"DEPOSITO EFECTIVO OFICINA TELECOMM 30035, REFERENCIA CLIENTE 0000000000"
27/02/2015,27/02/2015,0,DEP.EFECTIVO 131801048,0,2102,5618.00,,12442.21,7747,
27/02/2015,27/02/2015,0,DEP.EFECTIVO 108204044,0,188,1437.50,,13879.71,7748,
27/02/2015,27/02/2015,0,DEP.EFECTIVO 1282030416,0,3190,1192.50,,15072.21,7749,
27/02/2015,27/02/2015,0,DEP.EFECTIVO 137001049,0,2049,1320.00,,16392.21,7750,
27/02/2015,27/02/2015,0,DEP.EFECTIVO 113201043,0,2331,5110.50,,21502.71,7751,
27/02/2015,27/02/2015,0,DEP.EFECTIVO 098301049,0,2314,4671.00,,26173.71,7752,
27/02/2015,27/02/2015,0,DEP.EFECTIVO 111024041,0,1490,1441.50,,27615.21,7753,
27/02/2015,27/02/2015,0,DEP.EFECTIVO 13807042,0,2605,2646.00,,30261.21,7754,
27/02/2015,27/02/2015,0,ANUL.DEP.EFECTIVO 11102,501,1490,,"$1,441.50",28819.71,7755,
27/02/2015,27/02/2015,0,DEP.EFECTIVO 111024041,0,1490,1491.50,,30311.21,7756,
27/02/2015,27/02/2015,0,DEP.EFECTIVO 35102045,0,52,2152.00,,32463.21,7757,
27/02/2015,27/02/2015,0,DEP.EFECTIVO 124601041,0,116,4120.60,,36583.81,7758,
27/02/2015,27/02/2015,0,DEP.EFECTIVO 133448046,0,2460,1612.50,,38196.31,7759,
27/02/2015,27/02/2015,0,DEP.EFECTIVO 102210047,0,8114,3619.00,,41815.31,7760,
27/02/2015,27/02/2015,0,DEP.EFECTIVO 118701049,0,2314,2664.50,,44479.81,7761,
27/02/2015,27/02/2015,0,DEP.EFECTIVO 33402041,0,52,2310.00,,46789.81,7762,
27/02/2015,27/02/2015,0,DEP.EFECTIVO 041201049,0,2325,3045.50,,49835.31,7763,
27/02/2015,27/02/2015,0,DEP.EFECTIVO 96824043,0,1490,3485.50,,53320.81,7764,
27/02/2015,27/02/2015,0,DEP.EFECTIVO 104727045,0,3705,1699.50,,55020.31,7765,
27/02/2015,27/02/2015,0,DEP.EFECTIVO 122201019,0,2069,2458.00,,57478.31,7766,
27/02/2015,27/02/2015,0,DEP.EFECTIVO 117901044,0,2067,2970.00,,60448.31,7767,
27/02/2015,27/02/2015,0,DEP.EFECTIVO 34602045,0,52,1332.50,,61780.81,7768,
27/02/2015,27/02/2015,0,DEP.EFECTIVO 96901049,0,2043,2234.50,,64015.31,7769,
27/02/2015,27/02/2015,0,DEP.EFECTIVO 133201049,0,2183,1690.50,,65705.81,7770,
27/02/2015,27/02/2015,0,DEP.EFECTIVO 124301048,0,1474,2442.00,,68147.81,7771,
27/02/2015,27/02/2015,0,DEP.EFECTIVO 1145300458,0,2552,1214.00,,69361.81,7772,
27/02/2015,27/02/2015,0,DEP.EFECTIVO 1000300440,0,2552,908.00,,70269.81,7773,
27/02/2015,27/02/2015,0,DEP.EFECTIVO 1145300395,0,2552,0.05,,70269.86,7774,
27/02/2015,27/02/2015,0,DEP.EFECTIVO 1145300235,0,2552,0.50,,70270.36,7775,
27/02/2015,27/02/2015,0,DEP.EFECTIVO 92508046,0,3630,3147.00,,73417.36,7776,
27/02/2015,27/02/2015,0,DEP.EFECTIVO 094301049,0,1938,2038.50,,75455.86,7777,
27/02/2015,27/02/2015,0,DEP.EFECTIVO 120501049,0,2325,4372.00,,79827.86,7778,
27/02/2015,27/02/2015,0,DEP.EFECTIVO 122701049,0,2325,1191.50,,81019.36,7779,
27/02/2015,27/02/2015,0,DEP.EFECTIVO 106414041,0,8014,1948.00,,82967.36,7780,
27/02/2015,27/02/2015,0,DEP.EFECTIVO 110501049,0,8014,4051.50,,87018.86,7781,
27/02/2015,27/02/2015,0,DEP.EFECTIVO 99213046,0,648,1970.00,,88988.86,7782,
27/02/2015,27/02/2015,0,DEP.EFECTIVO 121701042,0,831,855.00,,89843.86,7783,
27/02/2015,27/02/2015,0,DEP.EFECTIVO 117513047,0,1566,1449.00,,91292.86,7784,
27/02/2015,27/02/2015,0,DEP.EFECTIVO 121201043,0,703,1532.00,,92824.86,7785,
27/02/2015,27/02/2015,0,DEP.EFECTIVO 13160104,0,117,2281.00,,95105.86,7786,
27/02/2015,27/02/2015,0,DEP.EFECTIVO 119613043,0,7726,885.30,,95991.16,7787,
27/02/2015,27/02/2015,0,DEP.EFECTIVO 1133010456,0,2043,3597.00,,99588.16,7788,
27/02/2015,27/02/2015,0,DEP.EFECTIVO 116501049,0,1424,2673.10,,102261.26,7789,
27/02/2015,27/02/2015,0,DEP.EFECTIVO 123601042,0,2306,363.00,,102624.26,7790,
27/02/2015,27/02/2015,0,DEP.EFECTIVO 126301049,0,464,3026.00,,105650.26,7791,
27/02/2015,27/02/2015,0,DEP.EFECTIVO 141601049,0,1938,2172.00,,107822.26,7792,
27/02/2015,27/02/2015,0,DEP.EFECTIVO 093001049,0,691,2285.50,,110107.76,7793,
27/02/2015,27/02/2015,0,DEP.EFECTIVO 117101041,0,1334,3406.60,,113514.36,7794,
27/02/2015,27/02/2015,0,DEP.EFECTIVO 129201019,0,295,2874.50,,116388.86,7795,
27/02/2015,27/02/2015,0,DEP.EFECTIVO 111501048,0,2290,3476.40,,119865.26,7796,
27/02/2015,27/02/2015,0,DEP.EFECTIVO 124901045,0,2104,3847.00,,123712.26,7797,
27/02/2015,27/02/2015,0,DEP.EFECTIVO 123501044,0,2104,967.00,,124679.26,7798,
27/02/2015,27/02/2015,0,DEP.EFECTIVO 150401040,0,2043,2848.00,,127527.26,7799,
27/02/2015,27/02/2015,0,DEP.EFECTIVO 141001043,0,116,916.50,,128443.76,7800,
27/02/2015,27/02/2015,0,DEP.EFECTIVO 137601019,0,1470,5083.50,,133527.26,7801,
27/02/2015,27/02/2015,0,DEP.EFECTIVO 101333048,0,3682,3460.00,,136987.26,7802,
27/02/2015,27/02/2015,0,DEP.EFECTIVO 102914044,0,8015,1413.00,,138400.26,7803,
27/02/2015,27/02/2015,0,DEP.EFECTIVO 108301049,0,3682,2217.70,,140617.96,7804,
27/02/2015,27/02/2015,0,DEP.EFECTIVO 095401049,0,295,2090.50,,142708.46,7805,
27/02/2015,27/02/2015,0,DEP.EFECTIVO 91402043,0,727,2009.70,,144718.16,7806,
27/02/2015,27/02/2015,0,DEP.EFECTIVO 119301049,0,1536,1865.50,,146583.66,7807,
27/02/2015,27/02/2015,0,DEP.EFECTIVO 099101019,0,1934,2930.50,,149514.16,7808,
27/02/2015,27/02/2015,0,DEP.EFECTIVO 133301047,0,274,1623.50,,151137.66,7809,
27/02/2015,27/02/2015,0,DEP.EFECTIVO 117001043,0,274,3676.00,,154813.66,7810,
27/02/2015,27/02/2015,0,DEP.EFECTIVO 131013040,0,1508,1229.00,,156042.66,7811,
27/02/2015,27/02/2015,0,DEP.EFECTIVO 119101049,0,464,2051.00,,158093.66,7812,
27/02/2015,27/02/2015,0,DEP.EFECTIVO 131013032,0,1508,1974.50,,160068.16,7813,
27/02/2015,27/02/2015,0,DEP.EFECTIVO 115901046,0,8013,1406.50,,161474.66,7814,
27/02/2015,27/02/2015,0,DEP.EFECTIVO 107701040,0,507,2012.00,,163486.66,7815,
27/02/2015,27/02/2015,0,DEP.EFECTIVO 121801040,0,2547,1299.50,,164786.16,7816,
27/02/2015,27/02/2015,0,DEP.EFECTIVO 103409044,0,7450,1531.00,,166317.16,7817,
27/02/2015,27/02/2015,0,DEP.EFECTIVO 104901049,0,2092,2182.00,,168499.16,7818,
27/02/2015,27/02/2015,0,DEP.EFECTIVO 105122048,0,1976,1215.50,,169714.66,7819,
27/02/2015,27/02/2015,0,DEP.EFECTIVO 112401049,0,8717,2689.00,,172403.66,7820,
27/02/2015,27/02/2015,0,DEP.EFECTIVO 1090100430,0,8115,5398.20,,177801.86,7821,
